GeoDesc,SNAP_PA_Participation_Persons,SNAP_NPA_Participation_Persons,SNAP_All_Participation_Persons,SNAP_PA_Participation_Households,SNAP_NPA_Participation_Households,SNAP_All_Participation_Households,SNAP_All_Issuance,Date,FIPS,SubCounty,Program
0603720 CA EBT LOS ANGELES COUNTY DPSS,164288,865183,1029471,67840,472456,540296,264574869,2019-01-01,06037,20,EBT
0607105 CA EBT SAN BRNDINO CO DPSS AU,48632,271694,320326,18729,131031,149760,78415168,2019-01-01,06071,05,EBT
0600105 CA EBT ALAMEDA COUNTY DSS,9012,82250,91262,3976,48619,52595,23870825,2019-01-01,06001,05,EBT
0609101 CA EBT SIERRA CO HUMAN SVCS,13,205,218,6,125,131,52323,2019-01-01,06091,01,EBT
0605101 CA EBT MONO CO WELFARE DEPT,26,700,726,10,416,426,185007,2019-01-01,06051,01,EBT
0602501 CA EBT IMPERIAL CO DSW,5760,35061,40821,2069,15096,17165,9247895,2019-01-01,06025,01,EBT
0606101 CA EBT PLACER CO WELFARE DEPT,1292,12670,13962,541,7433,7974,3159278,2019-01-01,06061,01,EBT
0601501 CA EBT DEL NORTE CO DSW,875,3997,4872,307,2208,2515,1185907,2019-01-01,06015,01,EBT
0606301 CA EBT PLUMAS COUNTY DSS,164,1871,2035,65,1083,1148,496212,2019-01-01,06063,01,EBT
0604901 CA EBT MODOC COUNTY DSS,174,1123,1297,67,568,635,311501,2019-01-01,06049,01,EBT
0610501 CA EBT TRINITY CO DSW,157,1511,1668,67,883,950,424452,2019-01-01,06105,01,EBT
0601101 CA EBT COLUSA COUNTY DSW,166,1226,1392,70,576,646,311882,2019-01-01,06011,01,EBT
0609301 CA EBT SISKIYOU CO DSW,884,5605,6489,327,2889,3216,1531235,2019-01-01,06093,01,EBT
0602701 CA EBT INYO COUNTY WELF DEPT,216,1618,1834,74,929,1003,434652,2019-01-01,06027,01,EBT
0604301 CA EBT MARIPOSA CO DSW,200,1678,1878,77,967,1044,434440,2019-01-01,06043,01,EBT
0600501 CA EBT AMADOR COUNTY DSS,203,2368,2571,84,1377,1461,605278,2019-01-01,06005,01,EBT
0604701 CA EBT MERCED CO DPW,7695,42608,50303,2903,19478,22381,12224038,2019-01-01,06047,01,EBT
0610101 CA EBT SUTTER CO WELF DEPT,1780,9364,11144,622,4328,4950,2663913,2019-01-01,06101,01,EBT
0611301 CA EBT YOLO CO DSW,1529,15085,16614,622,9251,9873,4258550,2019-01-01,06113,01,EBT
0603101 CA EBT KINGS COUNTY DPW,3934,19016,22950,1395,9026,10421,5375710,2019-01-01,06031,01,EBT
0604501 CA EBT MENDOCINO CO WELF DEPT,950,10012,10962,382,5601,5983,2697172,2019-01-01,06045,01,EBT
0611101 CA EBT VENTURA CO.,5396,54515,59911,2174,30281,32455,14544248,2019-01-01,06111,01,EBT
0600901 CA EBT CALAVERAS CO DSW,333,4220,4553,133,2457,2590,1101240,2019-01-01,06009,01,EBT
0607901 CA EBT SAN LUIS OBISPO COUNTY DSS,1622,13116,14738,655,8385,9040,3641539,2019-01-01,06079,01,EBT
0607301 CA EBT SAN DIEGO CO DSS,24294,221582,245876,9113,122477,131590,58893303,2019-01-01,06073,01,EBT
0610301 CA EBT TEHAMA CO DSW,1097,7682,8779,416,3783,4199,2014139,2019-01-01,06103,01,EBT
0603501 CA EBT LASSEN CO DSW,519,2355,2874,197,1287,1484,710034,2019-01-01,06035,01,EBT
0610901 CA EBT TUOLUMNE CO WELF DEPT,477,4095,4572,199,2508,2707,1071260,2019-01-01,06109,01,EBT
0603301 CA EBT LAKE CO DEPT OF SOC SVCS,1133,10133,11266,455,5838,6293,2743986,2019-01-01,06033,01,EBT
0611501 CA EBT YUBA CO WELFARE DEPT,1970,10799,12769,726,5370,6096,3116621,2019-01-01,06115,01,EBT
0609701 CA EBT SONOMA CO DSW,2325,22451,24776,988,14155,15143,5960875,2019-01-01,06097,01,EBT
0605701 CA EBT NEVADA CO DPSS,552,6734,7286,224,4110,4334,1763140,2019-01-01,06057,01,EBT
0608901 CA EBT SHASTA CO DSW,2420,19184,21604,1008,10800,11808,5100974,2019-01-01,06089,01,EBT
0600302 CA EBT ALPINE COUNTY DSS,1,113,114,1,69,70,27657,2019-01-01,06003,02,EBT
0603902 CA EBT MADERA CO DSW,4249,21676,25925,1538,9287,10825,6258957,2019-01-01,06039,02,EBT
0608702 CA EBT SANTA CRUZ CO DSW,2048,21538,23586,840,12949,13789,5833499,2019-01-01,06087,02,EBT
0602902 CA EBT KERN,23703,123089,146792,9034,55525,64559,35743446,2019-01-01,06029,02,EBT
0601302 CA EBT CONTRA COSTA COUNTY DSS,6656,48723,55379,2899,26363,29262,13998166,2019-01-01,06013,02,EBT
0609902 CA EBT STANISLAUS CO. DSS,10450,61693,72143,3938,31131,35069,17274959,2019-01-01,06099,02,EBT
0600702 CA EBT BUTTE COUNTY DSS,3403,26143,29546,1380,15117,16497,7125483,2019-01-01,06007,02,EBT
0604102 CA EBT MARIN COUNTY DSW,946,8097,9043,429,5270,5699,2305757,2019-01-01,06041,02,EBT
0609502 CA EBT SOLANO CO DSW,4673,30268,34941,1974,17571,19545,8882819,2019-01-01,06095,02,EBT
0602102 CA EBT GLENN CO WELFARE DEPT,552,2619,3171,192,1284,1476,708959,2019-01-01,06021,02,EBT
0605502 CA EBT NAPA CO WELFARE DEPT,452,4748,5200,194,2477,2671,1136923,2019-01-01,06055,02,EBT
0607702 CA EBT SAN JOAQUIN CO HUMAN SVCS AGCY,12814,80655,93469,5317,38134,43451,22568521,2019-01-01,06077,02,EBT
0608502 CA EBT SANTA CLARA COUNTY DSS,6595,65940,72535,2762,36388,39150,17305903,2019-01-01,06085,02,EBT
0605302 CA EBT MONTEREY CO DSW,5303,36176,41479,2023,16917,18940,10154373,2019-01-01,06053,02,EBT
0606902 CA EBT SAN BENITO COUNTY DSS,612,3755,4367,233,1851,2084,1039121,2019-01-01,06069,02,EBT
0607502 CA EBT SAN FRANCISCO COUNTY DSS,3706,39548,43254,1780,29099,30879,11377008,2019-01-01,06075,02,EBT
0602303 CA EBT HUMBOLDT CO DSW,1979,17771,19750,781,11317,12098,4938387,2019-01-01,06023,03,EBT
0605903 CA EBT ORANGE CO DSW,18986,175041,194027,7478,94760,102238,47334270,2019-01-01,06059,03,EBT
0606703 CA EBT SACRAMENTO CO DSW,28368,156410,184778,10834,82208,93042,47630450,2019-01-01,06067,03,EBT
0608103 CA EBT SAN MATEO COUNTY DSS,1112,19591,20703,466,10788,11254,4710182,2019-01-01,06081,03,EBT
0606503 CA EBT RIVERSIDE COUNTY DSS,32556,204852,237408,12009,98926,110935,56634366,2019-01-01,06065,03,EBT
0601704 CA EBT EL DORADO COUNTY DSS,1080,9570,10650,450,5836,6286,2550842,2019-01-01,06017,04,EBT
0608304 CA EBT SANTA BARBARA CO DSW,5053,32180,37233,1998,18926,20924,9572350,2019-01-01,06083,04,EBT
0610704 CA EBT TULARE COUNTY DSS,18126,89951,108077,6632,42256,48888,27087097,2019-01-01,06107,04,EBT
0601904 CA EBT FRESNO COUNTY DSW,29269,172602,201871,10741,77578,88319,48950104,2019-01-01,06019,04,EBT
0600105 CA EBT ALAMEDA COUNTY DSS,11422,90612,102034,4904,50362,55266,14232669,2018-01-01,06001,05,EBT
0603720 CA EBT LOS ANGELES COUNTY DPSS,189006,893785,1082791,77181,472117,549298,148680422,2018-01-01,06037,20,EBT
0607105 CA EBT SAN BRNDINO CO DPSS AU,56198,290819,347017,21383,139035,160418,46033745,2018-01-01,06071,05,EBT
0605101 CA EBT MONO CO WELFARE DEPT,24,670,694,8,392,400,96700,2018-01-01,06051,01,EBT
0609101 CA EBT SIERRA CO HUMAN SVCS,18,241,259,8,145,153,36971,2018-01-01,06091,01,EBT
0603301 CA EBT LAKE CO DEPT OF SOC SVCS,1330,10321,11651,523,5861,6384,1548021,2018-01-01,06033,01,EBT
0607901 CA EBT SAN LUIS OBISPO COUNTY DSS,2025,14339,16364,806,8642,9448,2162518,2018-01-01,06079,01,EBT
0601101 CA EBT COLUSA COUNTY DSW,140,1341,1481,60,620,680,187619,2018-01-01,06011,01,EBT
0611101 CA EBT VENTURA CO.,6690,60125,66815,2626,31597,34223,8727564,2018-01-01,06111,01,EBT
0606301 CA EBT PLUMAS COUNTY DSS,165,2036,2201,69,1150,1219,287397,2018-01-01,06063,01,EBT
0606101 CA EBT PLACER CO WELFARE DEPT,1535,14163,15698,583,7949,8532,1949721,2018-01-01,06061,01,EBT
0610501 CA EBT TRINITY CO DSW,178,1494,1672,72,918,990,232774,2018-01-01,06105,01,EBT
0602701 CA EBT INYO COUNTY WELF DEPT,230,1766,1996,81,949,1030,246769,2018-01-01,06027,01,EBT
0604901 CA EBT MODOC COUNTY DSS,220,1024,1244,81,513,594,161775,2018-01-01,06049,01,EBT
0608901 CA EBT SHASTA CO DSW,2681,20334,23015,1116,11226,12342,2968356,2018-01-01,06089,01,EBT
0607301 CA EBT SAN DIEGO CO DSS,29998,229951,259949,10847,120769,131616,33463588,2018-01-01,06073,01,EBT
0601501 CA EBT DEL NORTE CO DSW,971,4224,5195,355,2247,2602,677876,2018-01-01,06015,01,EBT
0609301 CA EBT SISKIYOU CO DSW,942,5463,6405,357,2764,3121,826420,2018-01-01,06093,01,EBT
0604301 CA EBT MARIPOSA CO DSW,272,1649,1921,104,932,1036,247242,2018-01-01,06043,01,EBT
0600501 CA EBT AMADOR COUNTY DSS,313,2602,2915,120,1489,1609,376758,2018-01-01,06005,01,EBT
0609701 CA EBT SONOMA CO DSW,2880,26054,28934,1181,15467,16648,3724923,2018-01-01,06097,01,EBT
0610101 CA EBT SUTTER CO WELF DEPT,1899,10267,12166,674,4666,5340,1571077,2018-01-01,06101,01,EBT
0602501 CA EBT IMPERIAL CO DSW,6225,34438,40663,2210,14793,17003,5029062,2018-01-01,06025,01,EBT
0610301 CA EBT TEHAMA CO DSW,1080,7897,8977,424,3758,4182,1124430,2018-01-01,06103,01,EBT
0603101 CA EBT KINGS COUNTY DPW,3933,19845,23778,1459,9237,10696,2987273,2018-01-01,06031,01,EBT
0604501 CA EBT MENDOCINO CO WELF DEPT,1146,10340,11486,456,5801,6257,1572888,2018-01-01,06045,01,EBT
0603501 CA EBT LASSEN CO DSW,574,2468,3042,206,1308,1514,401203,2018-01-01,06035,01,EBT
0600901 CA EBT CALAVERAS CO DSW,556,4430,4986,208,2559,2767,643519,2018-01-01,06009,01,EBT
0611301 CA EBT YOLO CO DSW,1950,16240,18190,741,9284,10025,2466272,2018-01-01,06113,01,EBT
0605701 CA EBT NEVADA CO DPSS,580,6306,6886,238,3774,4012,927817,2018-01-01,06057,01,EBT
0611501 CA EBT YUBA CO WELFARE DEPT,2093,10730,12823,755,5281,6036,1681007,2018-01-01,06115,01,EBT
0610901 CA EBT TUOLUMNE CO WELF DEPT,597,4099,4696,247,2430,2677,607349,2018-01-01,06109,01,EBT
0604701 CA EBT MERCED CO DPW,9039,43975,53014,3320,19793,23113,6854585,2018-01-01,06047,01,EBT
0600302 CA EBT ALPINE COUNTY DSS,2,137,139,2,77,79,16010,2018-01-01,06003,02,EBT
0605502 CA EBT NAPA CO WELFARE DEPT,626,5421,6047,258,2783,3041,746358,2018-01-01,06055,02,EBT
0604102 CA EBT MARIN COUNTY DSW,1189,8294,9483,518,5328,5846,1306479,2018-01-01,06041,02,EBT
0602902 CA EBT KERN,25270,131016,156286,9482,58415,67897,20500319,2018-01-01,06029,02,EBT
0607702 CA EBT SAN JOAQUIN CO HUMAN SVCS AGCY,15127,86738,101865,6188,40210,46398,13122178,2018-01-01,06077,02,EBT
0605302 CA EBT MONTEREY CO DSW,6209,40683,46892,2378,18719,21097,6432877,2018-01-01,06053,02,EBT
0608502 CA EBT SANTA CLARA COUNTY DSS,8373,76935,85308,3415,41164,44579,11042532,2018-01-01,06085,02,EBT
0607502 CA EBT SAN FRANCISCO COUNTY DSS,4100,43699,47799,1901,30273,32174,6613841,2018-01-01,06075,02,EBT
0603902 CA EBT MADERA CO DSW,4603,22717,27320,1654,9682,11336,3535270,2018-01-01,06039,02,EBT
0609502 CA EBT SOLANO CO DSW,5169,32704,37873,2179,18462,20641,5178221,2018-01-01,06095,02,EBT
0601302 CA EBT CONTRA COSTA COUNTY DSS,8259,53061,61320,3515,27622,31137,8393239,2018-01-01,06013,02,EBT
0602102 CA EBT GLENN CO WELFARE DEPT,504,2914,3418,193,1298,1491,407717,2018-01-01,06021,02,EBT
0608702 CA EBT SANTA CRUZ CO DSW,2451,23489,25940,982,13572,14554,3494876,2018-01-01,06087,02,EBT
0600702 CA EBT BUTTE COUNTY DSS,3750,27224,30974,1507,15466,16973,4161424,2018-01-01,06007,02,EBT
0609902 CA EBT STANISLAUS CO. DSS,12339,67426,79765,4600,33627,38227,10470123,2018-01-01,06099,02,EBT
0606902 CA EBT SAN BENITO COUNTY DSS,699,3938,4637,254,1866,2120,591035,2018-01-01,06069,02,EBT
0602303 CA EBT HUMBOLDT CO DSW,1986,18044,20030,804,11206,12010,2727419,2018-01-01,06023,03,EBT
0606703 CA EBT SACRAMENTO CO DSW,35528,162149,197677,13109,82136,95245,27305059,2018-01-01,06067,03,EBT
0606503 CA EBT RIVERSIDE COUNTY DSS,37888,224137,262025,13894,105781,119675,33874434,2018-01-01,06065,03,EBT
0605903 CA EBT ORANGE CO DSW,23354,199467,222821,9047,102736,111783,29276844,2018-01-01,06059,03,EBT
0608103 CA EBT SAN MATEO COUNTY DSS,1434,22844,24278,605,12219,12824,3022597,2018-01-01,06081,03,EBT
0610704 CA EBT TULARE COUNTY DSS,19911,96262,116173,7214,43749,50963,15470157,2018-01-01,06107,04,EBT
0608304 CA EBT SANTA BARBARA CO DSW,5648,33239,38887,2189,17594,19783,5239567,2018-01-01,06083,04,EBT
0601904 CA EBT FRESNO COUNTY DSW,30974,173632,204606,11447,77530,88977,28527812,2018-01-01,06019,04,EBT
0601704 CA EBT EL DORADO COUNTY DSS,1132,10173,11305,488,6027,6515,1476224,2018-01-01,06017,04,EBT
0600105 CA EBT ALAMEDA COUNTY DSS,10073,87628,97701,4358,49244,53602,13679425,2018-07-01,06001,05,EBT
0603720 CA EBT LOS ANGELES COUNTY DPSS,175150,880164,1055314,72017,471768,543785,145292627,2018-07-01,06037,20,EBT
0607105 CA EBT SAN BRNDINO CO DPSS AU,52664,281451,334115,20122,134920,155042,44545544,2018-07-01,06071,05,EBT
0609101 CA EBT SIERRA CO HUMAN SVCS,15,211,226,6,129,135,26904,2018-07-01,06091,01,EBT
0606101 CA EBT PLACER CO WELFARE DEPT,1315,13172,14487,524,7584,8108,1824319,2018-07-01,06061,01,EBT
0605101 CA EBT MONO CO WELFARE DEPT,41,578,619,14,340,354,80394,2018-07-01,06051,01,EBT
0608901 CA EBT SHASTA CO DSW,2444,19863,22307,1042,11026,12068,2871468,2018-07-01,06089,01,EBT
0606301 CA EBT PLUMAS COUNTY DSS,136,1861,1997,58,1046,1104,260661,2018-07-01,06063,01,EBT
0601101 CA EBT COLUSA COUNTY DSW,138,1271,1409,59,597,656,171921,2018-07-01,06011,01,EBT
0610501 CA EBT TRINITY CO DSW,156,1466,1622,68,898,966,222472,2018-07-01,06105,01,EBT
0601501 CA EBT DEL NORTE CO DSW,914,4030,4944,331,2169,2500,642216,2018-07-01,06015,01,EBT
0602701 CA EBT INYO COUNTY WELF DEPT,230,1697,1927,83,939,1022,240779,2018-07-01,06027,01,EBT
0603101 CA EBT KINGS COUNTY DPW,3797,19197,22994,1364,9036,10400,2895068,2018-07-01,06031,01,EBT
0610101 CA EBT SUTTER CO WELF DEPT,1687,9673,11360,597,4419,5016,1468903,2018-07-01,06101,01,EBT
0604901 CA EBT MODOC COUNTY DSS,218,987,1205,87,506,593,162275,2018-07-01,06049,01,EBT
0604301 CA EBT MARIPOSA CO DSW,259,1545,1804,89,903,992,230016,2018-07-01,06043,01,EBT
0609301 CA EBT SISKIYOU CO DSW,939,5280,6219,351,2747,3098,796548,2018-07-01,06093,01,EBT
0600501 CA EBT AMADOR COUNTY DSS,278,2416,2694,105,1400,1505,349590,2018-07-01,06005,01,EBT
0611301 CA EBT YOLO CO DSW,1676,15696,17372,642,9185,9827,2359446,2018-07-01,06113,01,EBT
0607301 CA EBT SAN DIEGO CO DSS,26957,227843,254800,9875,121169,131044,32881076,2018-07-01,06073,01,EBT
0610301 CA EBT TEHAMA CO DSW,1036,7767,8803,409,3733,4142,1101427,2018-07-01,06103,01,EBT
0604501 CA EBT MENDOCINO CO WELF DEPT,1081,10122,11203,423,5668,6091,1533592,2018-07-01,06045,01,EBT
0607901 CA EBT SAN LUIS OBISPO COUNTY DSS,1677,13874,15551,684,8419,9103,2047640,2018-07-01,06079,01,EBT
0600901 CA EBT CALAVERAS CO DSW,476,4346,4822,176,2526,2702,625072,2018-07-01,06009,01,EBT
0604701 CA EBT MERCED CO DPW,8007,43353,51360,2997,19614,22611,6597217,2018-07-01,06047,01,EBT
0603501 CA EBT LASSEN CO DSW,525,2303,2828,196,1251,1447,386439,2018-07-01,06035,01,EBT
0611501 CA EBT YUBA CO WELFARE DEPT,1941,10771,12712,710,5260,5970,1672122,2018-07-01,06115,01,EBT
0603301 CA EBT LAKE CO DEPT OF SOC SVCS,1146,10098,11244,457,5749,6206,1480486,2018-07-01,06033,01,EBT
0610901 CA EBT TUOLUMNE CO WELF DEPT,500,4135,4635,208,2494,2702,597403,2018-07-01,06109,01,EBT
0611101 CA EBT VENTURA CO.,5794,57999,63793,2270,30944,33214,8316334,2018-07-01,06111,01,EBT
0605701 CA EBT NEVADA CO DPSS,575,6443,7018,239,3881,4120,950348,2018-07-01,06057,01,EBT
0602501 CA EBT IMPERIAL CO DSW,5636,33629,39265,2031,14654,16685,4887187,2018-07-01,06025,01,EBT
0609701 CA EBT SONOMA CO DSW,2436,24893,27329,1013,14971,15984,3504348,2018-07-01,06097,01,EBT
0600302 CA EBT ALPINE COUNTY DSS,4,118,122,4,68,72,14916,2018-07-01,06003,02,EBT
0607502 CA EBT SAN FRANCISCO COUNTY DSS,3834,42416,46250,1797,29736,31533,6405251,2018-07-01,06075,02,EBT
0609502 CA EBT SOLANO CO DSW,4880,31789,36669,2054,17934,19988,5000896,2018-07-01,06095,02,EBT
0608502 CA EBT SANTA CLARA COUNTY DSS,7466,70861,78327,3080,38677,41757,10167433,2018-07-01,06085,02,EBT
0602902 CA EBT KERN,23793,128534,152327,9014,57415,66429,19817888,2018-07-01,06029,02,EBT
0607702 CA EBT SAN JOAQUIN CO HUMAN SVCS AGCY,13872,84032,97904,5705,39304,45009,12613286,2018-07-01,06077,02,EBT
0608702 CA EBT SANTA CRUZ CO DSW,2153,22010,24163,877,13176,14053,3171449,2018-07-01,06087,02,EBT
0601302 CA EBT CONTRA COSTA COUNTY DSS,7527,51093,58620,3196,26885,30081,8006697,2018-07-01,06013,02,EBT
0609902 CA EBT STANISLAUS CO. DSS,11309,64714,76023,4230,32474,36704,9958885,2018-07-01,06099,02,EBT
0600702 CA EBT BUTTE COUNTY DSS,3484,26940,30424,1416,15303,16719,4017242,2018-07-01,06007,02,EBT
0605302 CA EBT MONTEREY CO DSW,4412,35679,40091,1698,16798,18496,5068283,2018-07-01,06053,02,EBT
0602102 CA EBT GLENN CO WELFARE DEPT,509,2814,3323,190,1313,1503,403961,2018-07-01,06021,02,EBT
0605502 CA EBT NAPA CO WELFARE DEPT,495,5061,5556,205,2634,2839,673658,2018-07-01,06055,02,EBT
0603902 CA EBT MADERA CO DSW,4076,22331,26407,1489,9527,11016,3348282,2018-07-01,06039,02,EBT
0604102 CA EBT MARIN COUNTY DSW,1068,8329,9397,481,5381,5862,1309515,2018-07-01,06041,02,EBT
0606902 CA EBT SAN BENITO COUNTY DSS,637,3843,4480,250,1839,2089,575112,2018-07-01,06069,02,EBT
0608103 CA EBT SAN MATEO COUNTY DSS,1267,21203,22470,533,11493,12026,2832569,2018-07-01,06081,03,EBT
0602303 CA EBT HUMBOLDT CO DSW,2009,17453,19462,813,10993,11806,2638601,2018-07-01,06023,03,EBT
0606503 CA EBT RIVERSIDE COUNTY DSS,34958,214366,249324,12891,102163,115054,32377308,2018-07-01,06065,03,EBT
0606703 CA EBT SACRAMENTO CO DSW,31582,160870,192452,11913,81549,93462,26663771,2018-07-01,06067,03,EBT
0605903 CA EBT ORANGE CO DSW,21019,190070,211089,8142,98829,106971,27706019,2018-07-01,06059,03,EBT
0610704 CA EBT TULARE COUNTY DSS,18628,93392,112020,6774,42462,49236,14995189,2018-07-01,06107,04,EBT
0601704 CA EBT EL DORADO COUNTY DSS,1028,9874,10902,445,5922,6367,1441004,2018-07-01,06017,04,EBT
0608304 CA EBT SANTA BARBARA CO DSW,4444,32651,37095,1731,17668,19399,4894252,2018-07-01,06083,04,EBT
0601904 CA EBT FRESNO COUNTY DSW,30326,180100,210426,11218,80769,91987,27598300,2018-07-01,06019,04,EBT
0603720 CA EBT LOS ANGELES COUNTY DPSS,211583,865615,1077198,86108,447786,533894,153267088,2017-01-01,06037,20,EBT
0600105 CA EBT ALAMEDA COUNTY DSS,13285,95503,108788,5742,51693,57435,15297316,2017-01-01,06001,05,EBT
0607105 CA EBT SAN BRNDINO CO DPSS AU,63161,309495,372656,23963,146556,170519,49890901,2017-01-01,06071,05,EBT
0605101 CA EBT MONO CO WELFARE DEPT,28,743,771,12,451,463,108540,2017-01-01,06051,01,EBT
0609101 CA EBT SIERRA CO HUMAN SVCS,44,251,295,16,151,167,38198,2017-01-01,06091,01,EBT
0610901 CA EBT TUOLUMNE CO WELF DEPT,681,4583,5264,274,2742,3016,686662,2017-01-01,06109,01,EBT
0611101 CA EBT VENTURA CO.,7328,65332,72660,2851,33490,36341,9575150,2017-01-01,06111,01,EBT
0611501 CA EBT YUBA CO WELFARE DEPT,2178,10678,12856,805,5190,5995,1730315,2017-01-01,06115,01,EBT
0604501 CA EBT MENDOCINO CO WELF DEPT,1396,10469,11865,554,5767,6321,1631962,2017-01-01,06045,01,EBT
0610501 CA EBT TRINITY CO DSW,139,1571,1710,60,926,986,236085,2017-01-01,06105,01,EBT
0604901 CA EBT MODOC COUNTY DSS,200,969,1169,75,475,550,157085,2017-01-01,06049,01,EBT
0603301 CA EBT LAKE CO DEPT OF SOC SVCS,1539,10657,12196,590,5875,6465,1636553,2017-01-01,06033,01,EBT
0601101 CA EBT COLUSA COUNTY DSW,209,1375,1584,82,594,676,198307,2017-01-01,06011,01,EBT
0611301 CA EBT YOLO CO DSW,2235,17036,19271,851,9102,9953,2586074,2017-01-01,06113,01,EBT
0606301 CA EBT PLUMAS COUNTY DSS,225,1918,2143,86,1084,1170,296888,2017-01-01,06063,01,EBT
0604301 CA EBT MARIPOSA CO DSW,239,1615,1854,90,910,1000,251225,2017-01-01,06043,01,EBT
0602701 CA EBT INYO COUNTY WELF DEPT,243,1672,1915,91,916,1007,243106,2017-01-01,06027,01,EBT
0604701 CA EBT MERCED CO DPW,9854,45314,55168,3687,20062,23749,7256414,2017-01-01,06047,01,EBT
0607901 CA EBT SAN LUIS OBISPO COUNTY DSS,2181,15137,17318,872,8805,9677,2325644,2017-01-01,06079,01,EBT
0601501 CA EBT DEL NORTE CO DSW,1076,4120,5196,370,2147,2517,678534,2017-01-01,06015,01,EBT
0609701 CA EBT SONOMA CO DSW,3375,27540,30915,1395,16064,17459,4026669,2017-01-01,06097,01,EBT
0609301 CA EBT SISKIYOU CO DSW,1018,5573,6591,380,2738,3118,869290,2017-01-01,06093,01,EBT
0600501 CA EBT AMADOR COUNTY DSS,334,2824,3158,132,1567,1699,409116,2017-01-01,06005,01,EBT
0606101 CA EBT PLACER CO WELFARE DEPT,1718,14820,16538,676,8155,8831,2091618,2017-01-01,06061,01,EBT
0600901 CA EBT CALAVERAS CO DSW,505,4574,5079,188,2635,2823,660270,2017-01-01,06009,01,EBT
0610101 CA EBT SUTTER CO WELF DEPT,1897,10918,12815,709,4894,5603,1695258,2017-01-01,06101,01,EBT
0608901 CA EBT SHASTA CO DSW,2968,20686,23654,1226,11301,12527,3037678,2017-01-01,06089,01,EBT
0610301 CA EBT TEHAMA CO DSW,1250,8099,9349,475,3849,4324,1183692,2017-01-01,06103,01,EBT
0603101 CA EBT KINGS COUNTY DPW,4156,20225,24381,1510,9237,10747,3098667,2017-01-01,06031,01,EBT
0607301 CA EBT SAN DIEGO CO DSS,34597,239392,273989,12519,122984,135503,35799451,2017-01-01,06073,01,EBT
0603501 CA EBT LASSEN CO DSW,650,2495,3145,236,1369,1605,429782,2017-01-01,06035,01,EBT
0605701 CA EBT NEVADA CO DPSS,598,6728,7326,244,3969,4213,979443,2017-01-01,06057,01,EBT
0602501 CA EBT IMPERIAL CO DSW,6495,35471,41966,2299,15033,17332,5264975,2017-01-01,06025,01,EBT
0600302 CA EBT ALPINE COUNTY DSS,0,141,141,0,86,86,17382,2017-01-01,06003,02,EBT
0606902 CA EBT SAN BENITO COUNTY DSS,692,4509,5201,257,2066,2323,667704,2017-01-01,06069,02,EBT
0604102 CA EBT MARIN COUNTY DSW,1192,8575,9767,548,5416,5964,1360115,2017-01-01,06041,02,EBT
0605502 CA EBT NAPA CO WELFARE DEPT,756,6058,6814,306,3053,3359,838477,2017-01-01,06055,02,EBT
0608702 CA EBT SANTA CRUZ CO DSW,2743,24057,26800,1094,13533,14627,3606630,2017-01-01,06087,02,EBT
0600702 CA EBT BUTTE COUNTY DSS,4100,26911,31011,1668,14870,16538,4163674,2017-01-01,06007,02,EBT
0601302 CA EBT CONTRA COSTA COUNTY DSS,9252,53822,63074,3972,27568,31540,8812710,2017-01-01,06013,02,EBT
0607702 CA EBT SAN JOAQUIN CO HUMAN SVCS AGCY,16893,93719,110612,6792,42591,49383,14544537,2017-01-01,06077,02,EBT
0609502 CA EBT SOLANO CO DSW,5826,34268,40094,2449,18845,21294,5513879,2017-01-01,06095,02,EBT
0602102 CA EBT GLENN CO WELFARE DEPT,558,2958,3516,211,1319,1530,436164,2017-01-01,06021,02,EBT
0609902 CA EBT STANISLAUS CO. DSS,13858,70830,84688,5348,35029,40377,11219581,2017-01-01,06099,02,EBT
0602902 CA EBT KERN,26632,135150,161782,9964,59518,69482,21359069,2017-01-01,06029,02,EBT
0605302 CA EBT MONTEREY CO DSW,7198,43712,50910,2801,19956,22757,7008477,2017-01-01,06053,02,EBT
0607502 CA EBT SAN FRANCISCO COUNTY DSS,4458,45212,49670,2034,30677,32711,6947907,2017-01-01,06075,02,EBT
0603902 CA EBT MADERA CO DSW,7867,23827,31694,1783,10017,11800,3754344,2017-01-01,06039,02,EBT
0608502 CA EBT SANTA CLARA COUNTY DSS,9980,86202,96182,4095,44993,49088,12732065,2017-01-01,06085,02,EBT
0608103 CA EBT SAN MATEO COUNTY DSS,1839,25062,26901,776,13189,13965,3459656,2017-01-01,06081,03,EBT
0605903 CA EBT ORANGE CO DSW,26581,214731,241312,10290,108123,118413,32018307,2017-01-01,06059,03,EBT
0602303 CA EBT HUMBOLDT CO DSW,2138,18696,20834,860,11561,12421,2870939,2017-01-01,06023,03,EBT
0606703 CA EBT SACRAMENTO CO DSW,37182,167871,205053,14239,84098,98337,28752900,2017-01-01,06067,03,EBT
0606503 CA EBT RIVERSIDE COUNTY DSS,39943,237479,277422,14828,110193,125021,36243428,2017-01-01,06065,03,EBT
0601704 CA EBT EL DORADO COUNTY DSS,1316,11022,12338,536,6428,6964,1620356,2017-01-01,06017,04,EBT
0608304 CA EBT SANTA BARBARA CO DSW,6147,32958,39105,2381,16562,18943,5287715,2017-01-01,06083,04,EBT
0601904 CA EBT FRESNO COUNTY DSW,33850,176555,210405,12384,77869,90253,30488828,2017-01-01,06019,04,EBT
0610704 CA EBT TULARE COUNTY DSS,20286,99502,119788,7421,44260,51681,16155684,2017-01-01,06107,04,EBT
0600105 CA EBT ALAMEDA COUNTY DSS,14927,97688,112615,6414,52659,59073,16064163,2016-07-01,06001,05,EBT
0607105 CA EBT SAN BRNDINO CO DPSS AU,66276,323666,389942,24909,153794,178703,53072540,2016-07-01,06071,05,EBT
0603720 CA EBT LOS ANGELES COUNTY DPSS,205733,879403,1085136,83597,461424,545021,159303295,2016-07-01,06037,20,EBT
0607301 CA EBT SAN DIEGO CO DSS,37106,246141,283247,13570,127486,141056,37865475,2016-07-01,06073,01,EBT
0608901 CA EBT SHASTA CO DSW,3089,21080,24169,1283,11651,12934,3177528,2016-07-01,06089,01,EBT
0611501 CA EBT YUBA CO WELFARE DEPT,2086,11114,13200,774,5351,6125,1780508,2016-07-01,06115,01,EBT
0609101 CA EBT SIERRA CO HUMAN SVCS,22,242,264,9,148,157,34784,2016-07-01,06091,01,EBT
0605701 CA EBT NEVADA CO DPSS,678,6989,7667,269,4098,4367,1041072,2016-07-01,06057,01,EBT
0605101 CA EBT MONO CO WELFARE DEPT,41,740,781,15,432,447,103372,2016-07-01,06051,01,EBT
0610301 CA EBT TEHAMA CO DSW,1387,8546,9933,530,4029,4559,1266829,2016-07-01,06103,01,EBT
0610901 CA EBT TUOLUMNE CO WELF DEPT,720,4683,5403,283,2840,3123,717359,2016-07-01,06109,01,EBT
0610501 CA EBT TRINITY CO DSW,156,1552,1708,62,912,974,233670,2016-07-01,06105,01,EBT
0604901 CA EBT MODOC COUNTY DSS,173,914,1087,71,449,520,145039,2016-07-01,06049,01,EBT
0601101 CA EBT COLUSA COUNTY DSW,201,1205,1406,78,550,628,177011,2016-07-01,06011,01,EBT
0606301 CA EBT PLUMAS COUNTY DSS,187,1837,2024,81,1020,1101,276379,2016-07-01,06063,01,EBT
0604501 CA EBT MENDOCINO CO WELF DEPT,1522,10869,12391,600,6043,6643,1709645,2016-07-01,06045,01,EBT
0603301 CA EBT LAKE CO DEPT OF SOC SVCS,1564,10774,12338,605,5996,6601,1670228,2016-07-01,06033,01,EBT
0602701 CA EBT INYO COUNTY WELF DEPT,263,1800,2063,96,970,1066,255755,2016-07-01,06027,01,EBT
0604301 CA EBT MARIPOSA CO DSW,310,1682,1992,115,966,1081,265689,2016-07-01,06043,01,EBT
0609301 CA EBT SISKIYOU CO DSW,1028,5662,6690,373,2795,3168,888285,2016-07-01,06093,01,EBT
0607901 CA EBT SAN LUIS OBISPO COUNTY DSS,2225,15816,18041,888,9054,9942,2438769,2016-07-01,06079,01,EBT
0603101 CA EBT KINGS COUNTY DPW,3901,20356,24257,1413,9257,10670,3077498,2016-07-01,06031,01,EBT
0604701 CA EBT MERCED CO DPW,10645,45570,56215,3973,20420,24393,7435789,2016-07-01,06047,01,EBT
0601501 CA EBT DEL NORTE CO DSW,1117,4182,5299,392,2216,2608,714005,2016-07-01,06015,01,EBT
0600501 CA EBT AMADOR COUNTY DSS,389,2934,3323,148,1617,1765,445710,2016-07-01,06005,01,EBT
0611301 CA EBT YOLO CO DSW,2450,17989,20439,936,9591,10527,2764735,2016-07-01,06113,01,EBT
0610101 CA EBT SUTTER CO WELF DEPT,1946,11084,13030,694,4998,5692,1714393,2016-07-01,06101,01,EBT
0609701 CA EBT SONOMA CO DSW,3531,29912,33443,1482,17464,18946,4408826,2016-07-01,06097,01,EBT
0606101 CA EBT PLACER CO WELFARE DEPT,1850,15745,17595,715,8640,9355,2240809,2016-07-01,06061,01,EBT
0600901 CA EBT CALAVERAS CO DSW,554,4581,5135,208,2570,2778,675339,2016-07-01,06009,01,EBT
0603501 CA EBT LASSEN CO DSW,618,2525,3143,218,1349,1567,434888,2016-07-01,06035,01,EBT
0602501 CA EBT IMPERIAL CO DSW,6458,35601,42059,2280,14996,17276,5393312,2016-07-01,06025,01,EBT
0611101 CA EBT VENTURA CO.,7290,66359,73649,2805,33982,36787,9865146,2016-07-01,06111,01,EBT
0600302 CA EBT ALPINE COUNTY DSS,0,154,154,0,93,93,18770,2016-07-01,06003,02,EBT
0606902 CA EBT SAN BENITO COUNTY DSS,661,4841,5502,257,2249,2506,696787,2016-07-01,06069,02,EBT
0605502 CA EBT NAPA CO WELFARE DEPT,749,6429,7178,306,3202,3508,880743,2016-07-01,06055,02,EBT
0608702 CA EBT SANTA CRUZ CO DSW,2650,23616,26266,1076,13397,14473,3474047,2016-07-01,06087,02,EBT
0604102 CA EBT MARIN COUNTY DSW,1275,8569,9844,568,5490,6058,1378914,2016-07-01,06041,02,EBT
0608502 CA EBT SANTA CLARA COUNTY DSS,10613,90605,101218,4408,47311,51719,13609753,2016-07-01,06085,02,EBT
0605302 CA EBT MONTEREY CO DSW,5984,41523,47507,2361,19317,21678,6116047,2016-07-01,06053,02,EBT
0601302 CA EBT CONTRA COSTA COUNTY DSS,9689,57095,66784,4157,29501,33658,9497612,2016-07-01,06013,02,EBT
0607702 CA EBT SAN JOAQUIN CO HUMAN SVCS AGCY,18437,96430,114867,7294,43994,51288,15385393,2016-07-01,06077,02,EBT
0607502 CA EBT SAN FRANCISCO COUNTY DSS,4803,46032,50835,2177,31467,33644,7321181,2016-07-01,06075,02,EBT
0603902 CA EBT MADERA CO DSW,4729,24192,28921,1713,10158,11871,3784611,2016-07-01,06039,02,EBT
0600702 CA EBT BUTTE COUNTY DSS,4320,27757,32077,1730,15198,16928,4330354,2016-07-01,06007,02,EBT
0602902 CA EBT KERN,26650,136102,162752,9940,60116,70056,21652194,2016-07-01,06029,02,EBT
0602102 CA EBT GLENN CO WELFARE DEPT,592,3093,3685,224,1358,1582,459601,2016-07-01,06021,02,EBT
0609902 CA EBT STANISLAUS CO. DSS,14502,72914,87416,5606,36200,41806,11747913,2016-07-01,06099,02,EBT
0609502 CA EBT SOLANO CO DSW,6038,35958,41996,2555,19737,22292,5912672,2016-07-01,06095,02,EBT
0608103 CA EBT SAN MATEO COUNTY DSS,2126,26297,28423,896,13855,14751,3685725,2016-07-01,06081,03,EBT
0602303 CA EBT HUMBOLDT CO DSW,2276,18831,21107,907,11532,12439,2889571,2016-07-01,06023,03,EBT
0606503 CA EBT RIVERSIDE COUNTY DSS,41492,243601,285093,15287,112978,128265,37767830,2016-07-01,06065,03,EBT
0606703 CA EBT SACRAMENTO CO DSW,37783,172171,209954,14558,86432,100990,29940887,2016-07-01,06067,03,EBT
0605903 CA EBT ORANGE CO DSW,28210,220330,248540,10976,110603,121579,33353674,2016-07-01,06059,03,EBT
0608304 CA EBT SANTA BARBARA CO DSW,5293,32345,37638,2051,16168,18219,4971672,2016-07-01,06083,04,EBT
0601704 CA EBT EL DORADO COUNTY DSS,1381,11459,12840,565,6671,7236,1726242,2016-07-01,06017,04,EBT
0610704 CA EBT TULARE COUNTY DSS,20495,99258,119753,7522,43897,51419,16097740,2016-07-01,06107,04,EBT
0601904 CA EBT FRESNO COUNTY DSW,33905,183489,217394,12527,81488,94015,31599250,2016-07-01,06019,04,EBT
0607105 CA EBT SAN BRNDINO CO DPSS AU,59632,299874,359506,22576,142404,164980,48286846,2017-07-01,06071,05,EBT
0603720 CA EBT LOS ANGELES COUNTY DPSS,197340,855014,1052354,80448,444426,524874,148482879,2017-07-01,06037,20,EBT
0600105 CA EBT ALAMEDA COUNTY DSS,11719,92429,104148,5038,50537,55575,14790381,2017-07-01,06001,05,EBT
0605101 CA EBT MONO CO WELFARE DEPT,30,643,673,9,383,392,92347,2017-07-01,06051,01,EBT
0604501 CA EBT MENDOCINO CO WELF DEPT,1304,10352,11656,522,5714,6236,1594738,2017-07-01,06045,01,EBT
0609101 CA EBT SIERRA CO HUMAN SVCS,27,232,259,11,144,155,36843,2017-07-01,06091,01,EBT
0611301 CA EBT YOLO CO DSW,2067,16477,18544,794,8962,9756,2486666,2017-07-01,06113,01,EBT
0603301 CA EBT LAKE CO DEPT OF SOC SVCS,1388,10345,11733,540,5801,6341,1562282,2017-07-01,06033,01,EBT
0611101 CA EBT VENTURA CO.,6509,61384,67893,2589,31788,34377,8940958,2017-07-01,06111,01,EBT
0607901 CA EBT SAN LUIS OBISPO COUNTY DSS,1986,14808,16794,798,8669,9467,2237329,2017-07-01,06079,01,EBT
0611501 CA EBT YUBA CO WELFARE DEPT,2157,10868,13025,800,5213,6013,1729175,2017-07-01,06115,01,EBT
0610501 CA EBT TRINITY CO DSW,147,1496,1643,62,874,936,225747,2017-07-01,06105,01,EBT
0606301 CA EBT PLUMAS COUNTY DSS,164,1786,1950,67,1041,1108,268641,2017-07-01,06063,01,EBT
0602701 CA EBT INYO COUNTY WELF DEPT,201,1726,1927,77,931,1008,246090,2017-07-01,06027,01,EBT
0604901 CA EBT MODOC COUNTY DSS,207,942,1149,78,461,539,153150,2017-07-01,06049,01,EBT
0604301 CA EBT MARIPOSA CO DSW,205,1618,1823,79,934,1013,235696,2017-07-01,06043,01,EBT
0601101 CA EBT COLUSA COUNTY DSW,196,1326,1522,80,605,685,185279,2017-07-01,06011,01,EBT
0609301 CA EBT SISKIYOU CO DSW,910,5403,6313,345,2722,3067,829275,2017-07-01,06093,01,EBT
0601501 CA EBT DEL NORTE CO DSW,1023,4220,5243,358,2204,2562,683062,2017-07-01,06015,01,EBT
0604701 CA EBT MERCED CO DPW,9358,44963,54321,3440,20022,23462,7052210,2017-07-01,06047,01,EBT
0606101 CA EBT PLACER CO WELFARE DEPT,1590,14433,16023,628,7998,8626,2027859,2017-07-01,06061,01,EBT
0600501 CA EBT AMADOR COUNTY DSS,300,2697,2997,118,1531,1649,389592,2017-07-01,06005,01,EBT
0603101 CA EBT KINGS COUNTY DPW,3908,19665,23573,1416,9018,10434,2963708,2017-07-01,06031,01,EBT
0608901 CA EBT SHASTA CO DSW,2816,20268,23084,1162,11146,12308,3013936,2017-07-01,06089,01,EBT
0602501 CA EBT IMPERIAL CO DSW,6264,34967,41231,2205,14827,17032,5160142,2017-07-01,06025,01,EBT
0610101 CA EBT SUTTER CO WELF DEPT,1937,10514,12451,683,4741,5424,1621524,2017-07-01,06101,01,EBT
0610301 CA EBT TEHAMA CO DSW,1145,8071,9216,439,3826,4265,1163025,2017-07-01,06103,01,EBT
0600901 CA EBT CALAVERAS CO DSW,511,4459,4970,192,2587,2779,658867,2017-07-01,06009,01,EBT
0609701 CA EBT SONOMA CO DSW,2997,26678,29675,1219,15771,16990,3858944,2017-07-01,06097,01,EBT
0603501 CA EBT LASSEN CO DSW,618,2545,3163,222,1362,1584,434649,2017-07-01,06035,01,EBT
0605701 CA EBT NEVADA CO DPSS,611,6477,7088,242,3865,4107,956674,2017-07-01,06057,01,EBT
0610901 CA EBT TUOLUMNE CO WELF DEPT,618,4331,4949,246,2559,2805,631882,2017-07-01,06109,01,EBT
0607301 CA EBT SAN DIEGO CO DSS,32421,230841,263262,11766,119570,131336,34596995,2017-07-01,06073,01,EBT
0600302 CA EBT ALPINE COUNTY DSS,1,137,138,1,75,76,16862,2017-07-01,06003,02,EBT
0609502 CA EBT SOLANO CO DSW,5530,33474,39004,2309,18489,20798,5381760,2017-07-01,06095,02,EBT
0605502 CA EBT NAPA CO WELFARE DEPT,616,5480,6096,262,2836,3098,744338,2017-07-01,06055,02,EBT
0604102 CA EBT MARIN COUNTY DSW,1188,8244,9432,526,5240,5766,1315560,2017-07-01,06041,02,EBT
0605302 CA EBT MONTEREY CO DSW,5344,38372,43716,2087,17962,20049,5567734,2017-07-01,06053,02,EBT
0607702 CA EBT SAN JOAQUIN CO HUMAN SVCS AGCY,15906,89945,105851,6444,41386,47830,13858577,2017-07-01,06077,02,EBT
0603902 CA EBT MADERA CO DSW,4389,23217,27606,1602,9779,11381,3615514,2017-07-01,06039,02,EBT
0601302 CA EBT CONTRA COSTA COUNTY DSS,8638,52901,61539,3669,27268,30937,8545164,2017-07-01,06013,02,EBT
0608502 CA EBT SANTA CLARA COUNTY DSS,9030,79794,88824,3711,41981,45692,11717736,2017-07-01,06085,02,EBT
0602902 CA EBT KERN,24972,133691,158663,9350,58950,68300,20779685,2017-07-01,06029,02,EBT
0607502 CA EBT SAN FRANCISCO COUNTY DSS,4253,44368,48621,1969,30631,32600,6809449,2017-07-01,06075,02,EBT
0602102 CA EBT GLENN CO WELFARE DEPT,491,2860,3351,191,1276,1467,402901,2017-07-01,06021,02,EBT
0609902 CA EBT STANISLAUS CO. DSS,13196,69166,82362,5072,34483,39555,10898718,2017-07-01,06099,02,EBT
0608702 CA EBT SANTA CRUZ CO DSW,2459,22829,25288,989,13236,14225,3332141,2017-07-01,06087,02,EBT
0606902 CA EBT SAN BENITO COUNTY DSS,617,4212,4829,230,1943,2173,605172,2017-07-01,06069,02,EBT
0600702 CA EBT BUTTE COUNTY DSS,3805,27050,30855,1531,15082,16613,4138288,2017-07-01,06007,02,EBT
0605903 CA EBT ORANGE CO DSW,24484,204272,228756,9500,103740,113240,30319975,2017-07-01,06059,03,EBT
0602303 CA EBT HUMBOLDT CO DSW,2063,18208,20271,831,11163,11994,2767622,2017-07-01,06023,03,EBT
0606703 CA EBT SACRAMENTO CO DSW,36636,164983,201619,13700,83083,96783,28730770,2017-07-01,06067,03,EBT
0608103 CA EBT SAN MATEO COUNTY DSS,1611,23673,25284,667,12575,13242,3225379,2017-07-01,06081,03,EBT
0606503 CA EBT RIVERSIDE COUNTY DSS,38261,229295,267556,14066,107285,121351,34947540,2017-07-01,06065,03,EBT
0608304 CA EBT SANTA BARBARA CO DSW,4956,31747,36703,1872,16179,18051,4855890,2017-07-01,06083,04,EBT
0610704 CA EBT TULARE COUNTY DSS,19168,96752,115920,7026,43154,50180,15594875,2017-07-01,06107,04,EBT
0601904 CA EBT FRESNO COUNTY DSW,31046,171673,202719,11423,76082,87505,29389273,2017-07-01,06019,04,EBT
0601704 CA EBT EL DORADO COUNTY DSS,1200,10805,12005,503,6298,6801,1582554,2017-07-01,06017,04,EBT
0609101 CA EBT SIERRA CO HUMAN SVCS,19,301,320,7,171,178,42314,2015-01-01,06091,01,EBT
0605101 CA EBT MONO CO WELFARE DEPT,43,803,846,16,481,497,116646,2015-01-01,06051,01,EBT
0600901 CA EBT CALAVERAS CO DSW,732,4680,5412,276,2615,2891,743951,2015-01-01,06009,01,EBT
0603501 CA EBT LASSEN CO DSW,767,2414,3181,288,1257,1545,452052,2015-01-01,06035,01,EBT
0611301 CA EBT YOLO CO DSW,2753,16922,19675,1059,8611,9670,2761290,2015-01-01,06113,01,EBT
0610101 CA EBT SUTTER CO WELF DEPT,2170,10811,12981,805,4811,5616,1807556,2015-01-01,06101,01,EBT
0604501 CA EBT MENDOCINO CO WELF DEPT,2041,11084,13125,807,6302,7109,1922247,2015-01-01,06045,01,EBT
0610501 CA EBT TRINITY CO DSW,193,1636,1829,77,919,996,266003,2015-01-01,06105,01,EBT
0610901 CA EBT TUOLUMNE CO WELF DEPT,844,4558,5402,338,2658,2996,774042,2015-01-01,06109,01,EBT
0604901 CA EBT MODOC COUNTY DSS,228,795,1023,85,382,467,135385,2015-01-01,06049,01,EBT
0603101 CA EBT KINGS COUNTY DPW,4373,19507,23880,1632,8580,10212,3221741,2015-01-01,06031,01,EBT
0607901 CA EBT SAN LUIS OBISPO COUNTY DSS,2802,15520,18322,1124,8681,9805,2544404,2015-01-01,06079,01,EBT
0602701 CA EBT INYO COUNTY WELF DEPT,298,1759,2057,111,928,1039,274549,2015-01-01,06027,01,EBT
0609701 CA EBT SONOMA CO DSW,4633,30687,35320,1903,17781,19684,4972095,2015-01-01,06097,01,EBT
0601101 CA EBT COLUSA COUNTY DSW,302,1317,1619,112,574,686,224642,2015-01-01,06011,01,EBT
0606301 CA EBT PLUMAS COUNTY DSS,295,1731,2026,114,944,1058,289911,2015-01-01,06063,01,EBT
0602501 CA EBT IMPERIAL CO DSW,6842,34752,41594,2428,14114,16542,5488422,2015-01-01,06025,01,EBT
0605701 CA EBT NEVADA CO DPSS,1052,6640,7692,400,3840,4240,1124432,2015-01-01,06057,01,EBT
0604301 CA EBT MARIPOSA CO DSW,405,1625,2030,152,920,1072,290663,2015-01-01,06043,01,EBT
0606101 CA EBT PLACER CO WELFARE DEPT,2361,15947,18308,927,8756,9683,2425850,2015-01-01,06061,01,EBT
0610301 CA EBT TEHAMA CO DSW,1819,8401,10220,672,4030,4702,1413715,2015-01-01,06103,01,EBT
0611501 CA EBT YUBA CO WELFARE DEPT,2558,10588,13146,930,5074,6004,1866275,2015-01-01,06115,01,EBT
0601501 CA EBT DEL NORTE CO DSW,1113,4015,5128,419,2047,2466,729491,2015-01-01,06015,01,EBT
0600501 CA EBT AMADOR COUNTY DSS,448,2827,3275,176,1543,1719,452332,2015-01-01,06005,01,EBT
0603301 CA EBT LAKE CO DEPT OF SOC SVCS,1792,9808,11600,689,5233,5922,1650082,2015-01-01,06033,01,EBT
0604701 CA EBT MERCED CO DPW,13171,44571,57742,4798,19822,24620,8053170,2015-01-01,06047,01,EBT
0609301 CA EBT SISKIYOU CO DSW,1245,5742,6987,457,2763,3220,971017,2015-01-01,06093,01,EBT
0611101 CA EBT VENTURA CO.,8906,64699,73605,3534,32681,36215,10293285,2015-01-01,06111,01,EBT
0608901 CA EBT SHASTA CO DSW,3683,21042,24725,1489,11324,12813,3372779,2015-01-01,06089,01,EBT
0607301 CA EBT SAN DIEGO CO DSS,47513,236728,284241,17636,120152,137788,39598249,2015-01-01,06073,01,EBT
0600302 CA EBT ALPINE COUNTY DSS,8,163,171,4,103,107,22714,2015-01-01,06003,02,EBT
0609902 CA EBT STANISLAUS CO. DSS,16898,74436,91334,6410,36083,42493,12882820,2015-01-01,06099,02,EBT
0603902 CA EBT MADERA CO DSW,5664,23580,29244,2089,9770,11859,4106006,2015-01-01,06039,02,EBT
0608702 CA EBT SANTA CRUZ CO DSW,3245,22083,25328,1335,11913,13248,3590932,2015-01-01,06087,02,EBT
0606902 CA EBT SAN BENITO COUNTY DSS,900,5264,6164,333,2389,2722,840703,2015-01-01,06069,02,EBT
0609502 CA EBT SOLANO CO DSW,7646,35490,43136,3160,19047,22207,6252410,2015-01-01,06095,02,EBT
0605502 CA EBT NAPA CO WELFARE DEPT,882,6450,7332,363,3181,3544,1001844,2015-01-01,06055,02,EBT
0602902 CA EBT KERN,30005,118867,148872,11119,52410,63529,21046114,2015-01-01,06029,02,EBT
0604102 CA EBT MARIN COUNTY DSW,1480,8574,10054,668,5490,6158,1496873,2015-01-01,06041,02,EBT
0605302 CA EBT MONTEREY CO DSW,9434,42779,52213,3756,19401,23157,7636934,2015-01-01,06053,02,EBT
0601302 CA EBT CONTRA COSTA COUNTY DSS,12604,58740,71344,5292,29883,35175,10551070,2015-01-01,06013,02,EBT
0607702 CA EBT SAN JOAQUIN CO HUMAN SVCS AGCY,23548,95618,119166,9147,42336,51483,16771777,2015-01-01,06077,02,EBT
0600702 CA EBT BUTTE COUNTY DSS,4977,26226,31203,2006,13951,15957,4389061,2015-01-01,06007,02,EBT
0607502 CA EBT SAN FRANCISCO COUNTY DSS,5649,43286,48935,2529,29307,31836,7339676,2015-01-01,06075,02,EBT
0608502 CA EBT SANTA CLARA COUNTY DSS,14856,95186,110042,6121,48030,54151,15518529,2015-01-01,06085,02,EBT
0602102 CA EBT GLENN CO WELFARE DEPT,688,2988,3676,251,1268,1519,474085,2015-01-01,06021,02,EBT
0606703 CA EBT SACRAMENTO CO DSW,45315,171824,217139,17676,85185,102861,32028887,2015-01-01,06067,03,EBT
0602303 CA EBT HUMBOLDT CO DSW,2577,17685,20262,1042,10453,11495,2846466,2015-01-01,06023,03,EBT
0605903 CA EBT ORANGE CO DSW,33530,215724,249254,13158,105490,118648,34999151,2015-01-01,06059,03,EBT
0606503 CA EBT RIVERSIDE COUNTY DSS,50100,241100,291200,18571,107787,126358,39477273,2015-01-01,06065,03,EBT
0608103 CA EBT SAN MATEO COUNTY DSS,3046,27986,31032,1257,14384,15641,4194997,2015-01-01,06081,03,EBT
0601904 CA EBT FRESNO COUNTY DSW,41946,184823,226769,15394,80902,96296,33687375,2015-01-01,06019,04,EBT
0601704 CA EBT EL DORADO COUNTY DSS,1530,11488,13018,605,6573,7178,1792653,2015-01-01,06017,04,EBT
0608304 CA EBT SANTA BARBARA CO DSW,7028,29881,36909,2746,14171,16917,5098554,2015-01-01,06083,04,EBT
0610704 CA EBT TULARE COUNTY DSS,25329,97574,122903,9198,42841,52039,17176264,2015-01-01,06107,04,EBT
0607105 CA EBT SAN BRNDINO CO DPSS AU,76788,319727,396515,28476,148146,176622,55324218,2015-01-01,06071,05,EBT
0600105 CA EBT ALAMEDA COUNTY DSS,20958,98246,119204,8932,51900,60832,17905417,2015-01-01,06001,05,EBT
0603720 CA EBT LOS ANGELES COUNTY DPSS,188408,981922,1170330,82317,496750,579067,174954729,2015-01-01,06037,20,EBT
0609101 CA EBT SIERRA CO HUMAN SVCS,27,272,299,12,154,166,42441,2014-01-01,06091,01,EBT
0605101 CA EBT MONO CO WELFARE DEPT,40,783,823,17,505,522,117831,2014-01-01,06051,01,EBT
0611101 CA EBT VENTURA CO.,8961,60285,69246,3614,29919,33533,9701674,2014-01-01,06111,01,EBT
0603501 CA EBT LASSEN CO DSW,761,2387,3148,291,1197,1488,448713,2014-01-01,06035,01,EBT
0600901 CA EBT CALAVERAS CO DSW,761,4288,5049,293,2356,2649,702800,2014-01-01,06009,01,EBT
0608901 CA EBT SHASTA CO DSW,4002,19866,23868,1589,10386,11975,3287619,2014-01-01,06089,01,EBT
0610101 CA EBT SUTTER CO WELF DEPT,2211,10447,12658,835,4560,5395,1747469,2014-01-01,06101,01,EBT
0604901 CA EBT MODOC COUNTY DSS,192,771,963,72,365,437,126511,2014-01-01,06049,01,EBT
0610501 CA EBT TRINITY CO DSW,188,1418,1606,80,768,848,230814,2014-01-01,06105,01,EBT
0604501 CA EBT MENDOCINO CO WELF DEPT,2159,11208,13367,869,6255,7124,1910380,2014-01-01,06045,01,EBT
0601101 CA EBT COLUSA COUNTY DSW,290,1452,1742,110,621,731,226220,2014-01-01,06011,01,EBT
0606301 CA EBT PLUMAS COUNTY DSS,298,1545,1843,110,798,908,251952,2014-01-01,06063,01,EBT
0602701 CA EBT INYO COUNTY WELF DEPT,322,1823,2145,116,934,1050,265591,2014-01-01,06027,01,EBT
0607901 CA EBT SAN LUIS OBISPO COUNTY DSS,2786,15144,17930,1145,8232,9377,2478683,2014-01-01,06079,01,EBT
0603101 CA EBT KINGS COUNTY DPW,4482,19189,23671,1661,8341,10002,3144599,2014-01-01,06031,01,EBT
0610901 CA EBT TUOLUMNE CO WELF DEPT,1001,4401,5402,388,2552,2940,748283,2014-01-01,06109,01,EBT
0604301 CA EBT MARIPOSA CO DSW,371,1660,2031,133,883,1016,281277,2014-01-01,06043,01,EBT
0602501 CA EBT IMPERIAL CO DSW,5973,32389,38362,2185,12941,15126,5022400,2014-01-01,06025,01,EBT
0607301 CA EBT SAN DIEGO CO DSS,47751,222108,269859,17553,109719,127272,37631075,2014-01-01,06073,01,EBT
0605701 CA EBT NEVADA CO DPSS,1080,6500,7580,419,3579,3998,1080530,2014-01-01,06057,01,EBT
0603301 CA EBT LAKE CO DEPT OF SOC SVCS,1763,8824,10587,683,4563,5246,1499336,2014-01-01,06033,01,EBT
0606101 CA EBT PLACER CO WELFARE DEPT,2472,15907,18379,942,8045,8987,2477695,2014-01-01,06061,01,EBT
0601501 CA EBT DEL NORTE CO DSW,1166,4026,5192,433,2117,2550,718846,2014-01-01,06015,01,EBT
0600501 CA EBT AMADOR COUNTY DSS,483,2939,3422,184,1565,1749,480860,2014-01-01,06005,01,EBT
0604701 CA EBT MERCED CO DPW,13146,42595,55741,4803,18530,23333,7734249,2014-01-01,06047,01,EBT
0610301 CA EBT TEHAMA CO DSW,1933,8450,10383,713,3923,4636,1414551,2014-01-01,06103,01,EBT
0611301 CA EBT YOLO CO DSW,2547,15100,17647,980,7371,8351,2466045,2014-01-01,06113,01,EBT
0611501 CA EBT YUBA CO WELFARE DEPT,2682,10304,12986,992,4871,5863,1837067,2014-01-01,06115,01,EBT
0609301 CA EBT SISKIYOU CO DSW,1344,5578,6922,485,2653,3138,938553,2014-01-01,06093,01,EBT
0609701 CA EBT SONOMA CO DSW,4894,29542,34436,2046,16655,18701,4913099,2014-01-01,06097,01,EBT
0600302 CA EBT ALPINE COUNTY DSS,7,169,176,3,106,109,23451,2014-01-01,06003,02,EBT
0601302 CA EBT CONTRA COSTA COUNTY DSS,13481,56985,70466,5645,28513,34158,10295760,2014-01-01,06013,02,EBT
0607702 CA EBT SAN JOAQUIN CO HUMAN SVCS AGCY,24506,89419,113925,9502,38298,47800,15936190,2014-01-01,06077,02,EBT
0605302 CA EBT MONTEREY CO DSW,10206,40803,51009,4160,18159,22319,7316554,2014-01-01,06053,02,EBT
0608502 CA EBT SANTA CLARA COUNTY DSS,16176,93790,109966,6764,45642,52406,15420802,2014-01-01,06085,02,EBT
0602902 CA EBT KERN,31177,115218,146395,11385,49052,60437,20266467,2014-01-01,06029,02,EBT
0605502 CA EBT NAPA CO WELFARE DEPT,971,6120,7091,393,3004,3397,998553,2014-01-01,06055,02,EBT
0606902 CA EBT SAN BENITO COUNTY DSS,1043,5303,6346,395,2351,2746,894307,2014-01-01,06069,02,EBT
0608702 CA EBT SANTA CRUZ CO DSW,3450,20130,23580,1419,10611,12030,3320003,2014-01-01,06087,02,EBT
0609502 CA EBT SOLANO CO DSW,8341,33924,42265,3480,17919,21399,6069962,2014-01-01,06095,02,EBT
0607502 CA EBT SAN FRANCISCO COUNTY DSS,6208,42539,48747,2763,28649,31412,7257332,2014-01-01,06075,02,EBT
0609902 CA EBT STANISLAUS CO. DSS,18173,73699,91872,6868,35257,42125,12841498,2014-01-01,06099,02,EBT
0604102 CA EBT MARIN COUNTY DSW,1639,8094,9733,748,5075,5823,1456095,2014-01-01,06041,02,EBT
0600702 CA EBT BUTTE COUNTY DSS,5018,25255,30273,2028,12869,14897,4216681,2014-01-01,06007,02,EBT
0602102 CA EBT GLENN CO WELFARE DEPT,655,2940,3595,237,1233,1470,472258,2014-01-01,06021,02,EBT
0603902 CA EBT MADERA CO DSW,5498,22681,28179,2041,9157,11198,3853304,2014-01-01,06039,02,EBT
0602303 CA EBT HUMBOLDT CO DSW,2538,14635,17173,1042,8213,9255,2449020,2014-01-01,06023,03,EBT
0606703 CA EBT SACRAMENTO CO DSW,45919,164824,210743,18087,78082,96169,30432632,2014-01-01,06067,03,EBT
0605903 CA EBT ORANGE CO DSW,33775,207943,241718,13227,98559,111786,33366049,2014-01-01,06059,03,EBT
0606503 CA EBT RIVERSIDE COUNTY DSS,53661,231950,285611,19658,100799,120457,38868930,2014-01-01,06065,03,EBT
0608103 CA EBT SAN MATEO COUNTY DSS,3683,27665,31348,1483,13996,15479,4291460,2014-01-01,06081,03,EBT
0601904 CA EBT FRESNO COUNTY DSW,43122,182428,225550,15910,78710,94620,31877049,2014-01-01,06019,04,EBT
0601704 CA EBT EL DORADO COUNTY DSS,1388,10470,11858,559,5909,6468,1671702,2014-01-01,06017,04,EBT
0610704 CA EBT TULARE COUNTY DSS,25671,93512,119183,9367,39472,48839,16511745,2014-01-01,06107,04,EBT
0608304 CA EBT SANTA BARBARA CO DSW,6821,27874,34695,2740,12789,15529,4852464,2014-01-01,06083,04,EBT
0600105 CA EBT ALAMEDA COUNTY DSS,23149,102634,125783,9914,53538,63452,18513758,2014-01-01,06001,05,EBT
0607105 CA EBT SAN BRNDINO CO DPSS AU,76319,304469,380788,28376,137079,165455,53145908,2014-01-01,06071,05,EBT
0603720 CA EBT LOS ANGELES COUNTY DPSS,202122,961275,1163397,88644,478438,567082,172267652,2014-01-01,06037,20,EBT
0603720 CA EBT LOS ANGELES COUNTY DPSS,185980,946782,1132762,84544,483300,567844,164766923,2016-01-01,06037,20,EBT
0600105 CA EBT ALAMEDA COUNTY DSS,16539,98881,115420,7101,52948,60049,16731000,2016-01-01,06001,05,EBT
0607105 CA EBT SAN BRNDINO CO DPSS AU,70943,323983,394926,26584,152999,179583,53920703,2016-01-01,06071,05,EBT
0609101 CA EBT SIERRA CO HUMAN SVCS,13,284,297,5,159,164,40675,2016-01-01,06091,01,EBT
0606101 CA EBT PLACER CO WELFARE DEPT,1998,15868,17866,775,8548,9323,2292118,2016-01-01,06061,01,EBT
0605101 CA EBT MONO CO WELFARE DEPT,48,747,795,15,432,447,105641,2016-01-01,06051,01,EBT
0607901 CA EBT SAN LUIS OBISPO COUNTY DSS,2622,15998,18620,1040,9052,10092,2530559,2016-01-01,06079,01,EBT
0611301 CA EBT YOLO CO DSW,2756,18313,21069,1040,9609,10649,2844033,2016-01-01,06113,01,EBT
0610301 CA EBT TEHAMA CO DSW,1491,8608,10099,548,4105,4653,1315091,2016-01-01,06103,01,EBT
0605701 CA EBT NEVADA CO DPSS,790,6886,7676,307,3994,4301,1057576,2016-01-01,06057,01,EBT
0610501 CA EBT TRINITY CO DSW,164,1632,1796,68,957,1025,256298,2016-01-01,06105,01,EBT
0610901 CA EBT TUOLUMNE CO WELF DEPT,842,4753,5595,329,2862,3191,745319,2016-01-01,06109,01,EBT
0604901 CA EBT MODOC COUNTY DSS,198,861,1059,78,413,491,135584,2016-01-01,06049,01,EBT
0601101 CA EBT COLUSA COUNTY DSW,232,1088,1320,88,500,588,183724,2016-01-01,06011,01,EBT
0603301 CA EBT LAKE CO DEPT OF SOC SVCS,1588,10983,12571,607,5978,6585,1728465,2016-01-01,06033,01,EBT
0608901 CA EBT SHASTA CO DSW,3439,21264,24703,1380,11512,12892,3219433,2016-01-01,06089,01,EBT
0611501 CA EBT YUBA CO WELFARE DEPT,2342,11178,13520,874,5437,6311,1873172,2016-01-01,06115,01,EBT
0604701 CA EBT MERCED CO DPW,12163,45828,57991,4458,20586,25044,7829038,2016-01-01,06047,01,EBT
0611101 CA EBT VENTURA CO.,8245,67269,75514,3182,34250,37432,10125001,2016-01-01,06111,01,EBT
0606301 CA EBT PLUMAS COUNTY DSS,288,1917,2205,115,1070,1185,302338,2016-01-01,06063,01,EBT
0602701 CA EBT INYO COUNTY WELF DEPT,330,1766,2096,118,960,1078,265229,2016-01-01,06027,01,EBT
0604301 CA EBT MARIPOSA CO DSW,356,1741,2097,126,1001,1127,277935,2016-01-01,06043,01,EBT
0609701 CA EBT SONOMA CO DSW,4016,30659,34675,1672,17788,19460,4658992,2016-01-01,06097,01,EBT
0602501 CA EBT IMPERIAL CO DSW,7074,35949,43023,2457,14951,17408,5490562,2016-01-01,06025,01,EBT
0601501 CA EBT DEL NORTE CO DSW,1137,4221,5358,414,2208,2622,726414,2016-01-01,06015,01,EBT
0607301 CA EBT SAN DIEGO CO DSS,41770,245831,287601,15263,126232,141495,38553686,2016-01-01,06073,01,EBT
0604501 CA EBT MENDOCINO CO WELF DEPT,1769,11274,13043,685,6242,6927,1826112,2016-01-01,06045,01,EBT
0600501 CA EBT AMADOR COUNTY DSS,481,2900,3381,183,1598,1781,459123,2016-01-01,06005,01,EBT
0603101 CA EBT KINGS COUNTY DPW,4002,20958,24960,1475,9412,10887,3218454,2016-01-01,06031,01,EBT
0609301 CA EBT SISKIYOU CO DSW,1283,5818,7101,459,2865,3324,936849,2016-01-01,06093,01,EBT
0600901 CA EBT CALAVERAS CO DSW,667,4566,5233,249,2568,2817,696144,2016-01-01,06009,01,EBT
0603501 CA EBT LASSEN CO DSW,691,2466,3157,252,1284,1536,438322,2016-01-01,06035,01,EBT
0610101 CA EBT SUTTER CO WELF DEPT,2136,11032,13168,767,4944,5711,1758435,2016-01-01,06101,01,EBT
0600302 CA EBT ALPINE COUNTY DSS,3,155,158,2,97,99,19332,2016-01-01,06003,02,EBT
0600702 CA EBT BUTTE COUNTY DSS,4520,27548,32068,1816,15028,16844,4388913,2016-01-01,06007,02,EBT
0606902 CA EBT SAN BENITO COUNTY DSS,778,5158,5936,283,2384,2667,778225,2016-01-01,06069,02,EBT
0609502 CA EBT SOLANO CO DSW,6909,36457,43366,2858,19890,22748,6114561,2016-01-01,06095,02,EBT
0605302 CA EBT MONTEREY CO DSW,8554,45544,54098,3384,20788,24172,7603308,2016-01-01,06053,02,EBT
0604102 CA EBT MARIN COUNTY DSW,1270,8777,10047,572,5592,6164,1423705,2016-01-01,06041,02,EBT
0607502 CA EBT SAN FRANCISCO COUNTY DSS,5304,44978,50282,2388,30567,32955,7254060,2016-01-01,06075,02,EBT
0605502 CA EBT NAPA CO WELFARE DEPT,834,6611,7445,345,3260,3605,943451,2016-01-01,06055,02,EBT
0602902 CA EBT KERN,29484,132890,162374,10900,58751,69651,21937222,2016-01-01,06029,02,EBT
0608502 CA EBT SANTA CLARA COUNTY DSS,12108,92110,104218,5018,47977,52995,14196763,2016-01-01,06085,02,EBT
0608702 CA EBT SANTA CRUZ CO DSW,2953,24451,27404,1207,13591,14798,3708999,2016-01-01,06087,02,EBT
0607702 CA EBT SAN JOAQUIN CO HUMAN SVCS AGCY,20085,98318,118403,7883,44479,52362,15984408,2016-01-01,06077,02,EBT
0609902 CA EBT STANISLAUS CO. DSS,15205,74684,89889,5844,36705,42549,12144320,2016-01-01,06099,02,EBT
0601302 CA EBT CONTRA COSTA COUNTY DSS,10704,58936,69640,4568,30283,34851,9959462,2016-01-01,06013,02,EBT
0603902 CA EBT MADERA CO DSW,5544,24541,30085,2009,10315,12324,4010946,2016-01-01,06039,02,EBT
0602102 CA EBT GLENN CO WELFARE DEPT,612,2955,3567,222,1302,1524,445761,2016-01-01,06021,02,EBT
0606503 CA EBT RIVERSIDE COUNTY DSS,45493,246322,291815,16690,113059,129749,38747029,2016-01-01,06065,03,EBT
0602303 CA EBT HUMBOLDT CO DSW,2477,18712,21189,985,11436,12421,2928804,2016-01-01,06023,03,EBT
0606703 CA EBT SACRAMENTO CO DSW,40964,174520,215484,15850,87332,103182,30782282,2016-01-01,06067,03,EBT
0608103 CA EBT SAN MATEO COUNTY DSS,2387,27633,30020,1008,14464,15472,3901021,2016-01-01,06081,03,EBT
0605903 CA EBT ORANGE CO DSW,31053,221929,252982,12018,109995,122013,34047228,2016-01-01,06059,03,EBT
0608304 CA EBT SANTA BARBARA CO DSW,6555,32906,39461,2577,16166,18743,5352226,2016-01-01,06083,04,EBT
0601704 CA EBT EL DORADO COUNTY DSS,1398,11533,12931,575,6631,7206,1738667,2016-01-01,06017,04,EBT
0601904 CA EBT FRESNO COUNTY DSW,38912,187611,226523,14200,83149,97349,32745333,2016-01-01,06019,04,EBT
0610704 CA EBT TULARE COUNTY DSS,23606,100803,124409,8573,44553,53126,16989062,2016-01-01,06107,04,EBT
0607301 CA EBT SAN DIEGO CO DSS,43792,243984,287776,16134,125838,141972,39542647,2015-07-01,06073,01,EBT
0609101 CA EBT SIERRA CO HUMAN SVCS,20,297,317,7,164,171,40594,2015-07-01,06091,01,EBT
0605101 CA EBT MONO CO WELFARE DEPT,31,823,854,13,506,519,115249,2015-07-01,06051,01,EBT
0600901 CA EBT CALAVERAS CO DSW,736,4748,5484,271,2646,2917,729975,2015-07-01,06009,01,EBT
0611301 CA EBT YOLO CO DSW,2737,17455,20192,1043,9055,10098,2749524,2015-07-01,06113,01,EBT
0603501 CA EBT LASSEN CO DSW,783,2420,3203,286,1253,1539,439891,2015-07-01,06035,01,EBT
0604901 CA EBT MODOC COUNTY DSS,179,786,965,70,385,455,126290,2015-07-01,06049,01,EBT
0610501 CA EBT TRINITY CO DSW,186,1680,1866,72,962,1034,271360,2015-07-01,06105,01,EBT
0607901 CA EBT SAN LUIS OBISPO COUNTY DSS,2764,15805,18569,1107,8957,10064,2554032,2015-07-01,06079,01,EBT
0605701 CA EBT NEVADA CO DPSS,900,6858,7758,341,3925,4266,1100832,2015-07-01,06057,01,EBT
0610901 CA EBT TUOLUMNE CO WELF DEPT,888,4699,5587,344,2805,3149,777457,2015-07-01,06109,01,EBT
0601101 CA EBT COLUSA COUNTY DSW,241,1318,1559,93,567,660,199142,2015-07-01,06011,01,EBT
0606301 CA EBT PLUMAS COUNTY DSS,237,1753,1990,97,963,1060,274202,2015-07-01,06063,01,EBT
0602701 CA EBT INYO COUNTY WELF DEPT,281,1786,2067,102,944,1046,269542,2015-07-01,06027,01,EBT
0606101 CA EBT PLACER CO WELFARE DEPT,2216,15884,18100,876,8493,9369,2365481,2015-07-01,06061,01,EBT
0610301 CA EBT TEHAMA CO DSW,1696,8810,10506,624,4179,4803,1387524,2015-07-01,06103,01,EBT
0602501 CA EBT IMPERIAL CO DSW,6953,36020,42973,2416,14782,17198,5559348,2015-07-01,06025,01,EBT
0611501 CA EBT YUBA CO WELFARE DEPT,2405,11172,13577,884,5407,6291,1882506,2015-07-01,06115,01,EBT
0603301 CA EBT LAKE CO DEPT OF SOC SVCS,1613,10482,12095,630,5609,6239,1659540,2015-07-01,06033,01,EBT
0604701 CA EBT MERCED CO DPW,12330,46338,58668,4480,20858,25338,7899938,2015-07-01,06047,01,EBT
0604301 CA EBT MARIPOSA CO DSW,422,1727,2149,152,969,1121,288737,2015-07-01,06043,01,EBT
0611101 CA EBT VENTURA CO.,8195,66154,74349,3232,33801,37033,10155160,2015-07-01,06111,01,EBT
0601501 CA EBT DEL NORTE CO DSW,1172,4032,5204,417,2097,2514,711822,2015-07-01,06015,01,EBT
0609301 CA EBT SISKIYOU CO DSW,1185,5798,6983,430,2815,3245,939385,2015-07-01,06093,01,EBT
0600501 CA EBT AMADOR COUNTY DSS,459,2984,3443,183,1639,1822,460014,2015-07-01,06005,01,EBT
0608901 CA EBT SHASTA CO DSW,3789,21455,25244,1507,11585,13092,3349067,2015-07-01,06089,01,EBT
0603101 CA EBT KINGS COUNTY DPW,4216,20564,24780,1515,9213,10728,3211802,2015-07-01,06031,01,EBT
0610101 CA EBT SUTTER CO WELF DEPT,2128,11024,13152,748,4935,5683,1760039,2015-07-01,06101,01,EBT
0609701 CA EBT SONOMA CO DSW,4360,31460,35820,1773,18271,20044,4915642,2015-07-01,06097,01,EBT
0604501 CA EBT MENDOCINO CO WELF DEPT,1915,11229,13144,762,6289,7051,1866521,2015-07-01,06045,01,EBT
0600302 CA EBT ALPINE COUNTY DSS,5,166,171,3,98,101,20814,2015-07-01,06003,02,EBT
0609902 CA EBT STANISLAUS CO. DSS,16247,76071,92318,6174,37290,43464,12642873,2015-07-01,06099,02,EBT
0606902 CA EBT SAN BENITO COUNTY DSS,783,5179,5962,290,2402,2692,806635,2015-07-01,06069,02,EBT
0607702 CA EBT SAN JOAQUIN CO HUMAN SVCS AGCY,22055,99158,121213,8533,44551,53084,16512421,2015-07-01,06077,02,EBT
0605502 CA EBT NAPA CO WELFARE DEPT,884,6470,7354,361,3239,3600,926745,2015-07-01,06055,02,EBT
0604102 CA EBT MARIN COUNTY DSW,1381,8936,10317,622,5739,6361,1486619,2015-07-01,06041,02,EBT
0600702 CA EBT BUTTE COUNTY DSS,4734,27382,32116,1905,14782,16687,4442852,2015-07-01,06007,02,EBT
0601302 CA EBT CONTRA COSTA COUNTY DSS,11837,59770,71607,4984,30784,35768,10465645,2015-07-01,06013,02,EBT
0609502 CA EBT SOLANO CO DSW,7132,36701,43833,2940,20086,23026,6256513,2015-07-01,06095,02,EBT
0607502 CA EBT SAN FRANCISCO COUNTY DSS,5470,44420,49890,2441,30332,32773,7324245,2015-07-01,06075,02,EBT
0608702 CA EBT SANTA CRUZ CO DSW,2951,22990,25941,1192,12674,13866,3449765,2015-07-01,06087,02,EBT
0608502 CA EBT SANTA CLARA COUNTY DSS,13483,94966,108449,5550,48650,54200,14989975,2015-07-01,06085,02,EBT
0605302 CA EBT MONTEREY CO DSW,6987,43279,50266,2736,19895,22631,6631729,2015-07-01,06053,02,EBT
0603902 CA EBT MADERA CO DSW,5436,24174,29610,1984,10052,12036,3970357,2015-07-01,06039,02,EBT
0602902 CA EBT KERN,29948,129370,159318,10965,56538,67503,21484667,2015-07-01,06029,02,EBT
0602102 CA EBT GLENN CO WELFARE DEPT,641,2993,3634,233,1293,1526,454055,2015-07-01,06021,02,EBT
0606503 CA EBT RIVERSIDE COUNTY DSS,48412,245345,293757,17715,111282,128997,39398650,2015-07-01,06065,03,EBT
0608103 CA EBT SAN MATEO COUNTY DSS,2729,28235,30964,1121,14853,15974,4116661,2015-07-01,06081,03,EBT
0606703 CA EBT SACRAMENTO CO DSW,43456,173652,217108,16794,87045,103839,31537359,2015-07-01,06067,03,EBT
0605903 CA EBT ORANGE CO DSW,32079,221002,253081,12480,109125,121605,34644189,2015-07-01,06059,03,EBT
0602303 CA EBT HUMBOLDT CO DSW,2541,18485,21026,1019,11048,12067,2927066,2015-07-01,06023,03,EBT
0601904 CA EBT FRESNO COUNTY DSW,38654,188723,227377,14109,83396,97505,33001227,2015-07-01,06019,04,EBT
0601704 CA EBT EL DORADO COUNTY DSS,1440,11789,13229,592,6793,7385,1792914,2015-07-01,06017,04,EBT
0610704 CA EBT TULARE COUNTY DSS,24079,98838,122917,8785,43703,52488,16702971,2015-07-01,06107,04,EBT
0608304 CA EBT SANTA BARBARA CO DSW,5943,30295,36238,2289,14624,16913,4836085,2015-07-01,06083,04,EBT
0600105 CA EBT ALAMEDA COUNTY DSS,18636,100189,118825,7977,53513,61490,17661771,2015-07-01,06001,05,EBT
0607105 CA EBT SAN BRNDINO CO DPSS AU,74638,326720,401358,27804,152832,180636,55389091,2015-07-01,06071,05,EBT
0603720 CA EBT LOS ANGELES COUNTY DPSS,177783,989708,1167491,77475,503712,581187,171808793,2015-07-01,06037,20,EBT
0609701 CA EBT SONOMA CO DSW,4936,29206,34142,2058,16508,18566,5243410,2013-07-01,06097,01,EBT
0609101 CA EBT SIERRA CO HUMAN SVCS,32,273,305,12,144,156,43933,2013-07-01,06091,01,EBT
0600901 CA EBT CALAVERAS CO DSW,714,4247,4961,273,2300,2573,744862,2013-07-01,06009,01,EBT
0605101 CA EBT MONO CO WELFARE DEPT,52,603,655,21,379,400,96993,2013-07-01,06051,01,EBT
0610101 CA EBT SUTTER CO WELF DEPT,2116,10265,12381,803,4394,5197,1790347,2013-07-01,06101,01,EBT
0603101 CA EBT KINGS COUNTY DPW,4291,19113,23404,1589,8312,9901,3289169,2013-07-01,06031,01,EBT
0604901 CA EBT MODOC COUNTY DSS,190,742,932,71,343,414,131416,2013-07-01,06049,01,EBT
0610501 CA EBT TRINITY CO DSW,170,1345,1515,74,688,762,232350,2013-07-01,06105,01,EBT
0606301 CA EBT PLUMAS COUNTY DSS,252,1351,1603,93,679,772,231625,2013-07-01,06063,01,EBT
0604501 CA EBT MENDOCINO CO WELF DEPT,2194,10963,13157,870,6034,6904,1993377,2013-07-01,06045,01,EBT
0601101 CA EBT COLUSA COUNTY DSW,268,1432,1700,103,606,709,234395,2013-07-01,06011,01,EBT
0610901 CA EBT TUOLUMNE CO WELF DEPT,948,4198,5146,366,2459,2825,771006,2013-07-01,06109,01,EBT
0603301 CA EBT LAKE CO DEPT OF SOC SVCS,1586,8846,10432,622,4595,5217,1576567,2013-07-01,06033,01,EBT
0604301 CA EBT MARIPOSA CO DSW,311,1543,1854,115,805,920,271132,2013-07-01,06043,01,EBT
0602701 CA EBT INYO COUNTY WELF DEPT,314,1807,2121,117,939,1056,299537,2013-07-01,06027,01,EBT
0607901 CA EBT SAN LUIS OBISPO COUNTY DSS,2829,14428,17257,1155,7727,8882,2545170,2013-07-01,06079,01,EBT
0608901 CA EBT SHASTA CO DSW,4237,19428,23665,1668,10223,11891,3488760,2013-07-01,06089,01,EBT
0600501 CA EBT AMADOR COUNTY DSS,407,2866,3273,159,1523,1682,482981,2013-07-01,06005,01,EBT
0601501 CA EBT DEL NORTE CO DSW,1097,4026,5123,421,2099,2520,758488,2013-07-01,06015,01,EBT
0604701 CA EBT MERCED CO DPW,12991,42450,55441,4775,18142,22917,8125308,2013-07-01,06047,01,EBT
0611101 CA EBT VENTURA CO.,8671,57851,66522,3507,28530,32037,9944069,2013-07-01,06111,01,EBT
0605701 CA EBT NEVADA CO DPSS,1119,6324,7443,436,3457,3893,1118594,2013-07-01,06057,01,EBT
0606101 CA EBT PLACER CO WELFARE DEPT,2505,15079,17584,950,7496,8446,2545096,2013-07-01,06061,01,EBT
0609301 CA EBT SISKIYOU CO DSW,1225,5254,6479,440,2456,2896,944488,2013-07-01,06093,01,EBT
0611501 CA EBT YUBA CO WELFARE DEPT,2564,10317,12881,960,4775,5735,1913469,2013-07-01,06115,01,EBT
0607301 CA EBT SAN DIEGO CO DSS,45628,211956,257584,16845,104559,121404,38887920,2013-07-01,06073,01,EBT
0610301 CA EBT TEHAMA CO DSW,1986,7910,9896,727,3585,4312,1440138,2013-07-01,06103,01,EBT
0611301 CA EBT YOLO CO DSW,2528,13809,16337,992,6736,7728,2446712,2013-07-01,06113,01,EBT
0602501 CA EBT IMPERIAL CO DSW,5635,31078,36713,2041,12360,14401,5183929,2013-07-01,06025,01,EBT
0603501 CA EBT LASSEN CO DSW,686,2284,2970,252,1174,1426,449987,2013-07-01,06035,01,EBT
0603902 CA EBT MADERA CO DSW,5360,21436,26796,2049,8541,10590,3879105,2013-07-01,06039,02,EBT
0601302 CA EBT CONTRA COSTA COUNTY DSS,13374,53894,67268,5634,26904,32538,10555359,2013-07-01,06013,02,EBT
0600302 CA EBT ALPINE COUNTY DSS,11,160,171,4,87,91,24563,2013-07-01,06003,02,EBT
0609902 CA EBT STANISLAUS CO. DSS,17727,73130,90857,6736,34736,41472,13410852,2013-07-01,06099,02,EBT
0607702 CA EBT SAN JOAQUIN CO HUMAN SVCS AGCY,23820,88590,112410,9307,37372,46679,16722120,2013-07-01,06077,02,EBT
0606902 CA EBT SAN BENITO COUNTY DSS,966,5233,6199,371,2303,2674,894278,2013-07-01,06069,02,EBT
0605502 CA EBT NAPA CO WELFARE DEPT,880,5756,6636,377,2794,3171,969651,2013-07-01,06055,02,EBT
0605302 CA EBT MONTEREY CO DSW,8410,37559,45969,3449,16711,20160,6668071,2013-07-01,06053,02,EBT
0609502 CA EBT SOLANO CO DSW,7732,33323,41055,3239,17453,20692,6345126,2013-07-01,06095,02,EBT
0607502 CA EBT SAN FRANCISCO COUNTY DSS,6067,42447,48514,2730,28559,31289,7762808,2013-07-01,06075,02,EBT
0602902 CA EBT KERN,31076,112953,144029,11473,47886,59359,21276128,2013-07-01,06029,02,EBT
0602102 CA EBT GLENN CO WELFARE DEPT,640,2894,3534,233,1195,1428,482506,2013-07-01,06021,02,EBT
0600702 CA EBT BUTTE COUNTY DSS,5075,25059,30134,2037,12662,14699,4467086,2013-07-01,06007,02,EBT
0608702 CA EBT SANTA CRUZ CO DSW,3093,19569,22662,1274,10341,11615,3382524,2013-07-01,06087,02,EBT
0608502 CA EBT SANTA CLARA COUNTY DSS,16400,91987,108387,6907,44343,51250,16215208,2013-07-01,06085,02,EBT
0604102 CA EBT MARIN COUNTY DSW,1680,7850,9530,765,4903,5668,1526874,2013-07-01,06041,02,EBT
0608103 CA EBT SAN MATEO COUNTY DSS,3769,24869,28638,1548,12663,14211,4373268,2013-07-01,06081,03,EBT
0605903 CA EBT ORANGE CO DSW,33050,196165,229215,13130,91171,104301,33883952,2013-07-01,06059,03,EBT
0606703 CA EBT SACRAMENTO CO DSW,43055,164763,207818,17085,76875,93960,32089743,2013-07-01,06067,03,EBT
0606503 CA EBT RIVERSIDE COUNTY DSS,51866,224633,276499,19150,96068,115218,40497027,2013-07-01,06065,03,EBT
0602303 CA EBT HUMBOLDT CO DSW,2411,14069,16480,988,7813,8801,2503146,2013-07-01,06023,03,EBT
0601704 CA EBT EL DORADO COUNTY DSS,1424,10295,11719,573,5802,6375,1765291,2013-07-01,06017,04,EBT
0601904 CA EBT FRESNO COUNTY DSW,41348,175563,216911,15467,75027,90494,32453615,2013-07-01,06019,04,EBT
0610704 CA EBT TULARE COUNTY DSS,24278,89666,113944,8856,37287,46143,16646097,2013-07-01,06107,04,EBT
0608304 CA EBT SANTA BARBARA CO DSW,6131,25973,32104,2492,11808,14300,4758922,2013-07-01,06083,04,EBT
0600105 CA EBT ALAMEDA COUNTY DSS,23295,100358,123653,9990,51994,61984,19542959,2013-07-01,06001,05,EBT
0607105 CA EBT SAN BRNDINO CO DPSS AU,74213,297754,371967,27613,131505,159118,55450001,2013-07-01,06071,05,EBT
0603720 CA EBT LOS ANGELES COUNTY DPSS,202064,933021,1135085,89169,462697,551866,180707344,2013-07-01,06037,20,EBT
0600105 CA EBT ALAMEDA COUNTY DSS,22748,100346,123094,9679,53343,63022,18053403,2014-07-01,06001,05,EBT
0607105 CA EBT SAN BRNDINO CO DPSS AU,77776,312552,390328,28909,143074,171983,54088700,2014-07-01,06071,05,EBT
0603720 CA EBT LOS ANGELES COUNTY DPSS,196868,981478,1178346,86003,493099,579102,174542797,2014-07-01,06037,20,EBT
0608901 CA EBT SHASTA CO DSW,3834,20788,24622,1540,11160,12700,3331153,2014-07-01,06089,01,EBT
0609101 CA EBT SIERRA CO HUMAN SVCS,22,272,294,9,154,163,41294,2014-07-01,06091,01,EBT
0611501 CA EBT YUBA CO WELFARE DEPT,2807,10589,13396,1035,4973,6008,1847522,2014-07-01,06115,01,EBT
0605101 CA EBT MONO CO WELFARE DEPT,35,817,852,15,506,521,118437,2014-07-01,06051,01,EBT
0610101 CA EBT SUTTER CO WELF DEPT,2103,10892,12995,786,4809,5595,1754234,2014-07-01,06101,01,EBT
0600901 CA EBT CALAVERAS CO DSW,762,4458,5220,282,2481,2763,710942,2014-07-01,06009,01,EBT
0611301 CA EBT YOLO CO DSW,2731,15197,17928,1074,7643,8717,2486436,2014-07-01,06113,01,EBT
0603501 CA EBT LASSEN CO DSW,814,2353,3167,319,1217,1536,445645,2014-07-01,06035,01,EBT
0604901 CA EBT MODOC COUNTY DSS,175,826,1001,69,398,467,128144,2014-07-01,06049,01,EBT
0604501 CA EBT MENDOCINO CO WELF DEPT,2116,11843,13959,849,6700,7549,1982762,2014-07-01,06045,01,EBT
0610501 CA EBT TRINITY CO DSW,188,1649,1837,82,918,1000,259847,2014-07-01,06105,01,EBT
0607901 CA EBT SAN LUIS OBISPO COUNTY DSS,2768,15139,17907,1120,8424,9544,2467333,2014-07-01,06079,01,EBT
0604701 CA EBT MERCED CO DPW,12945,44680,57625,4704,19632,24336,7818440,2014-07-01,06047,01,EBT
0603101 CA EBT KINGS COUNTY DPW,4446,19383,23829,1637,8514,10151,3090549,2014-07-01,06031,01,EBT
0602701 CA EBT INYO COUNTY WELF DEPT,308,1833,2141,106,958,1064,276166,2014-07-01,06027,01,EBT
0601101 CA EBT COLUSA COUNTY DSW,297,1421,1718,112,612,724,224413,2014-07-01,06011,01,EBT
0606301 CA EBT PLUMAS COUNTY DSS,303,1489,1792,115,840,955,259258,2014-07-01,06063,01,EBT
0604301 CA EBT MARIPOSA CO DSW,351,1622,1973,134,871,1005,276924,2014-07-01,06043,01,EBT
0610901 CA EBT TUOLUMNE CO WELF DEPT,1016,4531,5547,393,2614,3007,760289,2014-07-01,06109,01,EBT
0607301 CA EBT SAN DIEGO CO DSS,48846,248408,297254,18313,115091,133404,38347558,2014-07-01,06073,01,EBT
0603301 CA EBT LAKE CO DEPT OF SOC SVCS,1761,9245,11006,674,4836,5510,1555573,2014-07-01,06033,01,EBT
0605701 CA EBT NEVADA CO DPSS,1074,6719,7793,420,3796,4216,1122920,2014-07-01,06057,01,EBT
0600501 CA EBT AMADOR COUNTY DSS,444,2926,3370,174,1595,1769,462288,2014-07-01,06005,01,EBT
0601501 CA EBT DEL NORTE CO DSW,1157,4061,5218,433,2108,2541,710743,2014-07-01,06015,01,EBT
0602501 CA EBT IMPERIAL CO DSW,6213,33728,39941,2226,13563,15789,5173770,2014-07-01,06025,01,EBT
0609301 CA EBT SISKIYOU CO DSW,1213,5687,6900,442,2740,3182,931725,2014-07-01,06093,01,EBT
0609701 CA EBT SONOMA CO DSW,4738,29897,34635,1981,17197,19178,4844562,2014-07-01,06097,01,EBT
0606101 CA EBT PLACER CO WELFARE DEPT,2688,15681,18369,972,8196,9168,2423136,2014-07-01,06061,01,EBT
0610301 CA EBT TEHAMA CO DSW,1967,9163,11130,736,4264,5000,1488110,2014-07-01,06103,01,EBT
0611101 CA EBT VENTURA CO.,8931,67457,76388,3566,31224,34790,9771552,2014-07-01,06111,01,EBT
0600302 CA EBT ALPINE COUNTY DSS,14,180,194,5,109,114,24613,2014-07-01,06003,02,EBT
0605302 CA EBT MONTEREY CO DSW,7817,41070,48887,3092,18587,21679,6513248,2014-07-01,06053,02,EBT
0600702 CA EBT BUTTE COUNTY DSS,5194,25747,30941,2073,13458,15531,4268299,2014-07-01,06007,02,EBT
0601302 CA EBT CONTRA COSTA COUNTY DSS,13024,62366,75390,5473,29563,35036,10399419,2014-07-01,06013,02,EBT
0606902 CA EBT SAN BENITO COUNTY DSS,963,5178,6141,363,2338,2701,832355,2014-07-01,06069,02,EBT
0605502 CA EBT NAPA CO WELFARE DEPT,894,6341,7235,364,3130,3494,953034,2014-07-01,06055,02,EBT
0609502 CA EBT SOLANO CO DSW,8325,34962,43287,3459,18734,22193,6190118,2014-07-01,06095,02,EBT
0607702 CA EBT SAN JOAQUIN CO HUMAN SVCS AGCY,24111,93092,117203,9354,40701,50055,16190155,2014-07-01,06077,02,EBT
0609902 CA EBT STANISLAUS CO. DSS,17917,74648,92565,6806,35996,42802,12763865,2014-07-01,06099,02,EBT
0608502 CA EBT SANTA CLARA COUNTY DSS,16903,93368,110271,7332,48160,55492,15429065,2014-07-01,06085,02,EBT
0607502 CA EBT SAN FRANCISCO COUNTY DSS,6160,45610,51770,2749,29129,31878,7246471,2014-07-01,06075,02,EBT
0603902 CA EBT MADERA CO DSW,5440,23379,28819,1998,9490,11488,3834282,2014-07-01,06039,02,EBT
0602902 CA EBT KERN,30423,116925,147348,11215,50359,61574,20088485,2014-07-01,06029,02,EBT
0608702 CA EBT SANTA CRUZ CO DSW,3026,20638,23664,1255,11126,12381,3221809,2014-07-01,06087,02,EBT
0602102 CA EBT GLENN CO WELFARE DEPT,658,3025,3683,237,1273,1510,461649,2014-07-01,06021,02,EBT
0604102 CA EBT MARIN COUNTY DSW,1637,8426,10063,750,5334,6084,1476989,2014-07-01,06041,02,EBT
0602303 CA EBT HUMBOLDT CO DSW,2690,16370,19060,1083,9445,10528,2627455,2014-07-01,06023,03,EBT
0608103 CA EBT SAN MATEO COUNTY DSS,3407,27915,31322,1355,14343,15698,4234957,2014-07-01,06081,03,EBT
0605903 CA EBT ORANGE CO DSW,33563,231604,265167,13135,102142,115277,33796762,2014-07-01,06059,03,EBT
0606503 CA EBT RIVERSIDE COUNTY DSS,51703,236355,288058,19099,104652,123751,38615030,2014-07-01,06065,03,EBT
0606703 CA EBT SACRAMENTO CO DSW,45879,168685,214564,18101,82346,100447,31105196,2014-07-01,06067,03,EBT
0610704 CA EBT TULARE COUNTY DSS,25344,106319,131663,9237,41334,50571,16403144,2014-07-01,06107,04,EBT
0601904 CA EBT FRESNO COUNTY DSW,43182,185277,228459,15910,81931,97841,32259905,2014-07-01,06019,04,EBT
0608304 CA EBT SANTA BARBARA CO DSW,6752,27585,34337,2618,12990,15608,4565867,2014-07-01,06083,04,EBT
0601704 CA EBT EL DORADO COUNTY DSS,1528,10912,12440,610,6244,6854,1716038,2014-07-01,06017,04,EBT
0611501 CA EBT YUBA CO WELFARE DEPT,2703,10310,13013,1027,4734,5761,1924189,2012-07-01,06115,01,EBT
0610301 CA EBT TEHAMA CO DSW,2105,7764,9869,777,3431,4208,1424565,2012-07-01,06103,01,EBT
0603501 CA EBT LASSEN CO DSW,691,2242,2933,266,1120,1386,435651,2012-07-01,06035,01,EBT
0609701 CA EBT SONOMA CO DSW,5569,28524,34093,2315,15942,18257,5145754,2012-07-01,06097,01,EBT
0611301 CA EBT YOLO CO DSW,2685,13885,16570,1039,6597,7636,2443498,2012-07-01,06113,01,EBT
0605101 CA EBT MONO CO WELFARE DEPT,53,655,708,23,424,447,109481,2012-07-01,06051,01,EBT
0609101 CA EBT SIERRA CO HUMAN SVCS,67,235,302,23,133,156,41551,2012-07-01,06091,01,EBT
0611101 CA EBT VENTURA CO.,9141,54909,64050,3645,27503,31148,9258982,2012-07-01,06111,01,EBT
0610101 CA EBT SUTTER CO WELF DEPT,2346,9533,11879,838,4102,4940,1695534,2012-07-01,06101,01,EBT
0604901 CA EBT MODOC COUNTY DSS,196,801,997,76,362,438,131564,2012-07-01,06049,01,EBT
0600901 CA EBT CALAVERAS CO DSW,895,4098,4993,333,2187,2520,738886,2012-07-01,06009,01,EBT
0610501 CA EBT TRINITY CO DSW,205,1349,1554,81,694,775,231402,2012-07-01,06105,01,EBT
0606301 CA EBT PLUMAS COUNTY DSS,283,1370,1653,104,651,755,234952,2012-07-01,06063,01,EBT
0601101 CA EBT COLUSA COUNTY DSW,263,1459,1722,105,595,700,232029,2012-07-01,06011,01,EBT
0610901 CA EBT TUOLUMNE CO WELF DEPT,927,4167,5094,368,2384,2752,743482,2012-07-01,06109,01,EBT
0602701 CA EBT INYO COUNTY WELF DEPT,317,1624,1941,121,834,955,273175,2012-07-01,06027,01,EBT
0604501 CA EBT MENDOCINO CO WELF DEPT,2242,11355,13597,889,6330,7219,2029310,2012-07-01,06045,01,EBT
0603101 CA EBT KINGS COUNTY DPW,4421,18368,22789,1663,7893,9556,3149810,2012-07-01,06031,01,EBT
0604301 CA EBT MARIPOSA CO DSW,334,1470,1804,128,747,875,262372,2012-07-01,06043,01,EBT
0603301 CA EBT LAKE CO DEPT OF SOC SVCS,1762,8250,10012,668,4358,5026,1497313,2012-07-01,06033,01,EBT
0604701 CA EBT MERCED CO DPW,13129,40676,53805,4800,17165,21965,7780763,2012-07-01,06047,01,EBT
0607301 CA EBT SAN DIEGO CO DSS,48059,195446,243505,17600,93384,110984,36242725,2012-07-01,06073,01,EBT
0609301 CA EBT SISKIYOU CO DSW,1262,4832,6094,453,2264,2717,883787,2012-07-01,06093,01,EBT
0601501 CA EBT DEL NORTE CO DSW,1269,4162,5431,460,2160,2620,799799,2012-07-01,06015,01,EBT
0605701 CA EBT NEVADA CO DPSS,1179,5910,7089,462,3198,3660,1071008,2012-07-01,06057,01,EBT
0607901 CA EBT SAN LUIS OBISPO COUNTY DSS,3028,14162,17190,1230,7640,8870,2497093,2012-07-01,06079,01,EBT
0600501 CA EBT AMADOR COUNTY DSS,554,2723,3277,215,1498,1713,493215,2012-07-01,06005,01,EBT
0606101 CA EBT PLACER CO WELFARE DEPT,2537,15203,17740,994,7199,8193,2549799,2012-07-01,06061,01,EBT
0602501 CA EBT IMPERIAL CO DSW,6371,29359,35730,2276,11640,13916,4912043,2012-07-01,06025,01,EBT
0608901 CA EBT SHASTA CO DSW,4478,20502,24980,1774,10649,12423,3570154,2012-07-01,06089,01,EBT
0600302 CA EBT ALPINE COUNTY DSS,2,145,147,1,83,84,18737,2012-07-01,06003,02,EBT
0608702 CA EBT SANTA CRUZ CO DSW,3182,19129,22311,1300,9656,10956,3292526,2012-07-01,06087,02,EBT
0604102 CA EBT MARIN COUNTY DSW,1775,7399,9174,815,4632,5447,1429817,2012-07-01,06041,02,EBT
0609502 CA EBT SOLANO CO DSW,8139,31785,39924,3379,16489,19868,6068910,2012-07-01,06095,02,EBT
0600702 CA EBT BUTTE COUNTY DSS,5286,23876,29162,2120,11845,13965,4265873,2012-07-01,06007,02,EBT
0609902 CA EBT STANISLAUS CO. DSS,19172,69468,88640,7263,32697,39960,12810402,2012-07-01,06099,02,EBT
0608502 CA EBT SANTA CLARA COUNTY DSS,18353,85069,103422,7550,40446,47996,15302692,2012-07-01,06085,02,EBT
0606902 CA EBT SAN BENITO COUNTY DSS,1013,5056,6069,392,2201,2593,860161,2012-07-01,06069,02,EBT
0607502 CA EBT SAN FRANCISCO COUNTY DSS,6531,42487,49018,2971,28988,31959,7489763,2012-07-01,06075,02,EBT
0601302 CA EBT CONTRA COSTA COUNTY DSS,14439,53807,68246,6063,26717,32780,10409555,2012-07-01,06013,02,EBT
0602902 CA EBT KERN,31879,108068,139947,11717,45893,57610,20410745,2012-07-01,06029,02,EBT
0605502 CA EBT NAPA CO WELFARE DEPT,1122,6091,7213,465,2961,3426,1037973,2012-07-01,06055,02,EBT
0605302 CA EBT MONTEREY CO DSW,8935,35391,44326,3547,15718,19265,6343137,2012-07-01,06053,02,EBT
0603902 CA EBT MADERA CO DSW,5408,21185,26593,2016,8401,10417,3791441,2012-07-01,06039,02,EBT
0607702 CA EBT SAN JOAQUIN CO HUMAN SVCS AGCY,24365,82377,106742,9452,34076,43528,15733793,2012-07-01,06077,02,EBT
0602102 CA EBT GLENN CO WELFARE DEPT,670,2735,3405,255,1130,1385,466286,2012-07-01,06021,02,EBT
0602303 CA EBT HUMBOLDT CO DSW,2664,12811,15475,1057,7048,8105,2278600,2012-07-01,06023,03,EBT
0606503 CA EBT RIVERSIDE COUNTY DSS,53622,212476,266098,19516,89067,108583,37850525,2012-07-01,06065,03,EBT
0608103 CA EBT SAN MATEO COUNTY DSS,4763,22659,27422,1903,11436,13339,4010281,2012-07-01,06081,03,EBT
0606703 CA EBT SACRAMENTO CO DSW,45170,156587,201757,17811,72173,89984,30924277,2012-07-01,06067,03,EBT
0605903 CA EBT ORANGE CO DSW,33606,181642,215248,13279,83221,96500,30895331,2012-07-01,06059,03,EBT
0610704 CA EBT TULARE COUNTY DSS,24445,84761,109206,8971,35284,44255,15859476,2012-07-01,06107,04,EBT
0601904 CA EBT FRESNO COUNTY DSW,41868,172319,214187,15733,72825,88558,31689350,2012-07-01,06019,04,EBT
0608304 CA EBT SANTA BARBARA CO DSW,6716,25206,31922,2678,11485,14163,4514091,2012-07-01,06083,04,EBT
0601704 CA EBT EL DORADO COUNTY DSS,1671,9899,11570,659,5401,6060,1702421,2012-07-01,06017,04,EBT
0607105 CA EBT SAN BRNDINO CO DPSS AU,76349,283388,359737,28167,122846,151013,52635375,2012-07-01,06071,05,EBT
0600105 CA EBT ALAMEDA COUNTY DSS,24885,97485,122370,10616,50483,61099,18852147,2012-07-01,06001,05,EBT
0603720 CA EBT LOS ANGELES COUNTY DPSS,182917,897598,1080515,78986,432553,511539,166839099,2012-07-01,06037,20,EBT
0603501 CA EBT LASSEN CO DSW,668,2258,2926,259,1112,1371,435293,2012-01-01,06035,01,EBT
0610301 CA EBT TEHAMA CO DSW,2147,7239,9386,782,3202,3984,1354402,2012-01-01,06103,01,EBT
0611501 CA EBT YUBA CO WELFARE DEPT,2773,10009,12782,1043,4580,5623,1885429,2012-01-01,06115,01,EBT
0609101 CA EBT SIERRA CO HUMAN SVCS,61,201,262,21,103,124,38329,2012-01-01,06091,01,EBT
0605101 CA EBT MONO CO WELFARE DEPT,52,644,696,22,404,426,102820,2012-01-01,06051,01,EBT
0607901 CA EBT SAN LUIS OBISPO COUNTY DSS,3283,14315,17598,1312,7658,8970,2561076,2012-01-01,06079,01,EBT
0606101 CA EBT PLACER CO WELFARE DEPT,2803,14987,17790,1061,6882,7943,2509520,2012-01-01,06061,01,EBT
0604901 CA EBT MODOC COUNTY DSS,205,816,1021,78,347,425,137501,2012-01-01,06049,01,EBT
0610501 CA EBT TRINITY CO DSW,219,1305,1524,89,638,727,220561,2012-01-01,06105,01,EBT
0600901 CA EBT CALAVERAS CO DSW,943,3928,4871,360,2057,2417,732919,2012-01-01,06009,01,EBT
0604501 CA EBT MENDOCINO CO WELF DEPT,2227,11179,13406,879,5976,6855,1946214,2012-01-01,06045,01,EBT
0611301 CA EBT YOLO CO DSW,3003,13172,16175,1137,6210,7347,2393075,2012-01-01,06113,01,EBT
0606301 CA EBT PLUMAS COUNTY DSS,304,1260,1564,119,569,688,227160,2012-01-01,06063,01,EBT
0608901 CA EBT SHASTA CO DSW,4859,19513,24372,1911,10058,11969,3504753,2012-01-01,06089,01,EBT
0601101 CA EBT COLUSA COUNTY DSW,316,1385,1701,120,571,691,247843,2012-01-01,06011,01,EBT
0607301 CA EBT SAN DIEGO CO DSS,51209,186113,237322,18809,87889,106698,35120163,2012-01-01,06073,01,EBT
0610901 CA EBT TUOLUMNE CO WELF DEPT,958,4246,5204,379,2353,2732,757102,2012-01-01,06109,01,EBT
0602501 CA EBT IMPERIAL CO DSW,6908,28050,34958,2427,11144,13571,4785120,2012-01-01,06025,01,EBT
0604301 CA EBT MARIPOSA CO DSW,343,1386,1729,130,696,826,255621,2012-01-01,06043,01,EBT
0602701 CA EBT INYO COUNTY WELF DEPT,370,1576,1946,133,815,948,259994,2012-01-01,06027,01,EBT
0604701 CA EBT MERCED CO DPW,13781,38870,52651,5022,16193,21215,7644676,2012-01-01,06047,01,EBT
0611101 CA EBT VENTURA CO.,10176,52891,63067,4003,26341,30344,9142224,2012-01-01,06111,01,EBT
0609701 CA EBT SONOMA CO DSW,5945,25591,31536,2471,14066,16537,4760614,2012-01-01,06097,01,EBT
0610101 CA EBT SUTTER CO WELF DEPT,2603,8999,11602,947,3805,4752,1674374,2012-01-01,06101,01,EBT
0605701 CA EBT NEVADA CO DPSS,1186,5309,6495,463,2858,3321,988671,2012-01-01,06057,01,EBT
0609301 CA EBT SISKIYOU CO DSW,1273,4698,5971,485,2128,2613,870847,2012-01-01,06093,01,EBT
0603101 CA EBT KINGS COUNTY DPW,4680,17950,22630,1765,7631,9396,3155643,2012-01-01,06031,01,EBT
0600501 CA EBT AMADOR COUNTY DSS,571,2504,3075,230,1373,1603,463729,2012-01-01,06005,01,EBT
0601501 CA EBT DEL NORTE CO DSW,1332,4018,5350,495,2071,2566,786195,2012-01-01,06015,01,EBT
0603301 CA EBT LAKE CO DEPT OF SOC SVCS,1922,7984,9906,753,4120,4873,1477105,2012-01-01,06033,01,EBT
0608702 CA EBT SANTA CRUZ CO DSW,3683,16814,20497,1537,8535,10072,3164053,2012-01-01,06087,02,EBT
0600302 CA EBT ALPINE COUNTY DSS,12,140,152,5,77,82,20187,2012-01-01,06003,02,EBT
0602102 CA EBT GLENN CO WELFARE DEPT,686,2686,3372,262,1079,1341,463017,2012-01-01,06021,02,EBT
0605502 CA EBT NAPA CO WELFARE DEPT,1277,5737,7014,519,2746,3265,1022662,2012-01-01,06055,02,EBT
0607502 CA EBT SAN FRANCISCO COUNTY DSS,6858,42129,48987,3132,28693,31825,7435480,2012-01-01,06075,02,EBT
0603902 CA EBT MADERA CO DSW,5638,20462,26100,2119,8145,10264,3769219,2012-01-01,06039,02,EBT
0602902 CA EBT KERN,33495,102319,135814,12363,42624,54987,19818893,2012-01-01,06029,02,EBT
0605302 CA EBT MONTEREY CO DSW,11400,33229,44629,4691,14543,19234,6584582,2012-01-01,06053,02,EBT
0604102 CA EBT MARIN COUNTY DSW,1839,6940,8779,853,4395,5248,1371805,2012-01-01,06041,02,EBT
0601302 CA EBT CONTRA COSTA COUNTY DSS,14973,51522,66495,6235,25160,31395,10064075,2012-01-01,06013,02,EBT
0600702 CA EBT BUTTE COUNTY DSS,5543,22618,28161,2205,11210,13415,4135474,2012-01-01,06007,02,EBT
0609502 CA EBT SOLANO CO DSW,8621,30131,38752,3507,15529,19036,5898021,2012-01-01,06095,02,EBT
0607702 CA EBT SAN JOAQUIN CO HUMAN SVCS AGCY,25573,78327,103900,9949,31702,41651,15355939,2012-01-01,06077,02,EBT
0608502 CA EBT SANTA CLARA COUNTY DSS,20021,78848,98869,8166,37315,45481,14990428,2012-01-01,06085,02,EBT
0609902 CA EBT STANISLAUS CO. DSS,19698,65634,85332,7401,30534,37935,12429123,2012-01-01,06099,02,EBT
0606902 CA EBT SAN BENITO COUNTY DSS,1327,4829,6156,498,2129,2627,880022,2012-01-01,06069,02,EBT
0602303 CA EBT HUMBOLDT CO DSW,2682,12399,15081,1070,6827,7897,2236266,2012-01-01,06023,03,EBT
0608103 CA EBT SAN MATEO COUNTY DSS,5384,20313,25697,2119,10207,12326,3761872,2012-01-01,06081,03,EBT
0606703 CA EBT SACRAMENTO CO DSW,45814,151813,197627,18077,68661,86738,30294122,2012-01-01,06067,03,EBT
0605903 CA EBT ORANGE CO DSW,36199,170360,206559,14269,77284,91553,29548074,2012-01-01,06059,03,EBT
0606503 CA EBT RIVERSIDE COUNTY DSS,56368,201409,257777,20476,83303,103779,36632192,2012-01-01,06065,03,EBT
0608304 CA EBT SANTA BARBARA CO DSW,7592,23413,31005,3101,10533,13634,4524134,2012-01-01,06083,04,EBT
0610704 CA EBT TULARE COUNTY DSS,25351,82138,107489,9279,32763,42042,15679570,2012-01-01,06107,04,EBT
0601704 CA EBT EL DORADO COUNTY DSS,1739,9552,11291,682,5134,5816,1678007,2012-01-01,06017,04,EBT
0601904 CA EBT FRESNO COUNTY DSW,43232,167538,210770,16337,70405,86742,31211167,2012-01-01,06019,04,EBT
0600105 CA EBT ALAMEDA COUNTY DSS,26165,93784,119949,11100,48044,59144,18331639,2012-01-01,06001,05,EBT
0607105 CA EBT SAN BRNDINO CO DPSS AU,78104,266980,345084,28879,113519,142398,50311317,2012-01-01,06071,05,EBT
0603720 CA EBT LOS ANGELES COUNTY DPSS,219264,827686,1046950,95076,394882,489958,161444247,2012-01-01,06037,20,EBT
0610301 CA EBT TEHAMA CO DSW,2142,7576,9718,775,3422,4197,1415372,2013-01-01,06103,01,EBT
0609101 CA EBT SIERRA CO HUMAN SVCS,25,289,314,10,155,165,46385,2013-01-01,06091,01,EBT
0605101 CA EBT MONO CO WELFARE DEPT,48,654,702,20,394,414,106932,2013-01-01,06051,01,EBT
0607301 CA EBT SAN DIEGO CO DSS,48135,202690,250825,17691,97483,115174,37853449,2013-01-01,06073,01,EBT
0609701 CA EBT SONOMA CO DSW,6034,33996,40030,2863,21189,24052,5329565,2013-01-01,06097,01,EBT
0604501 CA EBT MENDOCINO CO WELF DEPT,2155,11270,13425,830,6263,7093,2053191,2013-01-01,06045,01,EBT
0600901 CA EBT CALAVERAS CO DSW,868,4131,4999,323,2245,2568,753920,2013-01-01,06009,01,EBT
0610101 CA EBT SUTTER CO WELF DEPT,2284,10018,12302,843,4261,5104,1792771,2013-01-01,06101,01,EBT
0604901 CA EBT MODOC COUNTY DSS,216,749,965,84,341,425,138477,2013-01-01,06049,01,EBT
0610501 CA EBT TRINITY CO DSW,189,1422,1611,84,718,802,239059,2013-01-01,06105,01,EBT
0602501 CA EBT IMPERIAL CO DSW,5952,30644,36596,2134,12167,14301,5108523,2013-01-01,06025,01,EBT
0604701 CA EBT MERCED CO DPW,13504,41527,55031,4957,17577,22534,8086981,2013-01-01,06047,01,EBT
0601101 CA EBT COLUSA COUNTY DSW,263,1551,1814,106,609,715,248448,2013-01-01,06011,01,EBT
0606301 CA EBT PLUMAS COUNTY DSS,320,1437,1757,115,698,813,250215,2013-01-01,06063,01,EBT
0603101 CA EBT KINGS COUNTY DPW,4453,18748,23201,1653,8119,9772,3282390,2013-01-01,06031,01,EBT
0604301 CA EBT MARIPOSA CO DSW,335,1501,1836,128,765,893,276870,2013-01-01,06043,01,EBT
0602701 CA EBT INYO COUNTY WELF DEPT,350,1630,1980,134,857,991,277318,2013-01-01,06027,01,EBT
0610901 CA EBT TUOLUMNE CO WELF DEPT,1078,4167,5245,420,2414,2834,779595,2013-01-01,06109,01,EBT
0603301 CA EBT LAKE CO DEPT OF SOC SVCS,1783,8420,10203,689,4432,5121,1556289,2013-01-01,06033,01,EBT
0611101 CA EBT VENTURA CO.,9438,57131,66569,3774,28286,32060,9967029,2013-01-01,06111,01,EBT
0605701 CA EBT NEVADA CO DPSS,1143,6236,7379,456,3411,3867,1122104,2013-01-01,06057,01,EBT
0600501 CA EBT AMADOR COUNTY DSS,527,2786,3313,201,1513,1714,505084,2013-01-01,06005,01,EBT
0601501 CA EBT DEL NORTE CO DSW,1234,4007,5241,457,2118,2575,775918,2013-01-01,06015,01,EBT
0607901 CA EBT SAN LUIS OBISPO COUNTY DSS,3017,14651,17668,1229,7833,9062,2598250,2013-01-01,06079,01,EBT
0608901 CA EBT SHASTA CO DSW,4354,19349,23703,1743,10137,11880,3498245,2013-01-01,06089,01,EBT
0611501 CA EBT YUBA CO WELFARE DEPT,2577,10261,12838,984,4684,5668,1906333,2013-01-01,06115,01,EBT
0606101 CA EBT PLACER CO WELFARE DEPT,2587,15034,17621,985,7280,8265,2559016,2013-01-01,06061,01,EBT
0611301 CA EBT YOLO CO DSW,2525,14159,16684,995,6778,7773,2511813,2013-01-01,06113,01,EBT
0603501 CA EBT LASSEN CO DSW,631,2266,2897,236,1161,1397,451586,2013-01-01,06035,01,EBT
0609301 CA EBT SISKIYOU CO DSW,1389,5030,6419,492,2367,2859,949923,2013-01-01,06093,01,EBT
0600302 CA EBT ALPINE COUNTY DSS,12,139,151,4,79,83,19878,2013-01-01,06003,02,EBT
0600702 CA EBT BUTTE COUNTY DSS,5154,24583,29737,2066,12186,14252,4416970,2013-01-01,06007,02,EBT
0604102 CA EBT MARIN COUNTY DSW,1707,7500,9207,787,4690,5477,1467134,2013-01-01,06041,02,EBT
0602902 CA EBT KERN,32798,110482,143280,12051,46898,58949,21301570,2013-01-01,06029,02,EBT
0603902 CA EBT MADERA CO DSW,5462,21157,26619,2073,8410,10483,3934777,2013-01-01,06039,02,EBT
0608502 CA EBT SANTA CLARA COUNTY DSS,17806,88779,106585,7327,42535,49862,16201208,2013-01-01,06085,02,EBT
0601302 CA EBT CONTRA COSTA COUNTY DSS,13824,54547,68371,5797,27244,33041,10667184,2013-01-01,06013,02,EBT
0605502 CA EBT NAPA CO WELFARE DEPT,1087,6009,7096,442,2881,3323,1054035,2013-01-01,06055,02,EBT
0606902 CA EBT SAN BENITO COUNTY DSS,1173,5173,6346,450,2247,2697,943135,2013-01-01,06069,02,EBT
0608702 CA EBT SANTA CRUZ CO DSW,3574,19366,22940,1483,10120,11603,3576554,2013-01-01,06087,02,EBT
0609502 CA EBT SOLANO CO DSW,7822,33286,41108,3280,17229,20509,6367906,2013-01-01,06095,02,EBT
0607702 CA EBT SAN JOAQUIN CO HUMAN SVCS AGCY,25006,85156,110162,9697,35624,45321,16541487,2013-01-01,06077,02,EBT
0609902 CA EBT STANISLAUS CO. DSS,18760,71552,90312,7156,33926,41082,13372986,2013-01-01,06099,02,EBT
0602102 CA EBT GLENN CO WELFARE DEPT,659,2883,3542,245,1161,1406,485387,2013-01-01,06021,02,EBT
0605302 CA EBT MONTEREY CO DSW,10464,37422,47886,4346,16480,20826,7428013,2013-01-01,06053,02,EBT
0607502 CA EBT SAN FRANCISCO COUNTY DSS,6199,42573,48772,2812,28559,31371,7740022,2013-01-01,06075,02,EBT
0602303 CA EBT HUMBOLDT CO DSW,2531,13128,15659,1033,7257,8290,2404514,2013-01-01,06023,03,EBT
0605903 CA EBT ORANGE CO DSW,34552,189729,224281,13635,87731,101366,33275907,2013-01-01,06059,03,EBT
0606703 CA EBT SACRAMENTO CO DSW,44838,163029,207867,17751,75225,92976,31983930,2013-01-01,06067,03,EBT
0608103 CA EBT SAN MATEO COUNTY DSS,4400,23390,27790,1773,11736,13509,4185616,2013-01-01,06081,03,EBT
0606503 CA EBT RIVERSIDE COUNTY DSS,54481,220607,275088,19965,93747,113712,40095837,2013-01-01,06065,03,EBT
0608304 CA EBT SANTA BARBARA CO DSW,7019,26020,33039,2868,11781,14649,4962770,2013-01-01,06083,04,EBT
0601904 CA EBT FRESNO COUNTY DSW,42591,176481,219072,15955,75160,91115,32914899,2013-01-01,06019,04,EBT
0601704 CA EBT EL DORADO COUNTY DSS,1703,10218,11921,660,5703,6363,1798774,2013-01-01,06017,04,EBT
0610704 CA EBT TULARE COUNTY DSS,24851,88407,113258,9125,36870,45995,16743858,2013-01-01,06107,04,EBT
0607105 CA EBT SAN BRNDINO CO DPSS AU,76797,290167,366964,28502,127636,156138,54773985,2013-01-01,06071,05,EBT
0600105 CA EBT ALAMEDA COUNTY DSS,24348,99974,124322,10394,51902,62296,19652923,2013-01-01,06001,05,EBT
0603720 CA EBT LOS ANGELES COUNTY DPSS,208944,911878,1120822,91290,450110,541400,178205670,2013-01-01,06037,20,EBT
